“	“	PUNCT	_
Meski	meski	SCONJ	_
Meski	meski	ADP	_
kebanyakan	banyak	DET	PronType=Ind
transisi	transisi	NOUN	Number=Sing
digital	digital	ADJ	_
yang	yang	PRON	PronType=Rel
yang	yang	SCONJ	_
yang	yang	PRON	_
terjadi	jadi	VERB	Mood=Ind|Voice=Pass
di	di	ADP	_
Amerika	Amerika	PROPN	_
Serikat	Serikat	PROPN	_
belum	belum	PART	Polarity=Neg
pernah	pernah	ADV	_
sebelumnya	belum	ADV	_
sebelumnya	belum	ADJ	_
,	,	PUNCT	_
kekuasaan	kuasa	NOUN	Number=Sing
damai	damai	ADJ	_
tidak	tidak	PART	Polarity=Neg
lah	lah	PART	_
begitu	begitu	PRON	PronType=Dem
begitu	begitu	ADV	_
”	”	PUNCT	_
tulis	tulis	VERB	Mood=Ind|Voice=Act
asisten	asisten	NOUN	Number=Sing
khusus	khusus	ADJ	_
Obama	Obama	PROPN	_
Kori	Kori	PROPN	_
Schulman	Schulman	PROPN	_
sebuah	buah	DET	Number=Sing|PronType=Ind
postingan	pos	NOUN	Number=Sing
postingan	postingan	NOUN	Number=Sing
blog	blog	NOUN	Number=Sing
pada	pada	ADP	_
pada	pada	SCONJ	_
hari	hari	NOUN	Number=Sing
Senin	Senin	PROPN	_
.	.	PUNCT	_
Bagi	bagi	ADP	_
mereka	mereka	PRON	Number=Plur|Person=3|PronType=Prs
mereka	mereka	PRON	Number=Plur|Person=3|Poss=Yes|PronType=Prs
mengikuti	ikut	VERB	Mood=Ind|Voice=Act
media	media	NOUN	Number=Sing
sosial	sosial	ADJ	_
Capitol	Capitol	PROPN	_
Hill	Hill	PROPN	_
ini	ini	PRON	PronType=Dem
ini	ini	DET	PronType=Dem
akan	akan	AUX	_
akan	akan	ADP	_
sedikit	sedikit	ADJ	_
berbeda	beda	VERB	Mood=Ind|Voice=Act
Namun	namun	CCONJ	_
seperti	seperti	ADP	_
seperti	seperti	SCONJ	_
retorika	retorika	NOUN	Number=Sing
nya	nya	PRON	Number=Sing|Person=3|Poss=Yes|PronType=Prs
nya	nya	PRON	Number=Sing|Person=3|PronType=Prs
nya	nya	DET	_
nya	nya	PRON	Number=Sing
nya	nya	PRON	_
tentang	tentang	ADP	_
tentang	tentang	SCONJ	_
pembatasan	batas	NOUN	Number=Sing
imigrasi	imigrasi	NOUN	Number=Sing
kandidat	kandidat	NOUN	Number=Sing
GOP	GOP	PROPN	Abbr=Yes
menyerukan	seru	VERB	Mood=Ind|Voice=Act
bahwa	bahwa	SCONJ	_
sebagai	bagai	ADP	_
sebagai	bagai	SCONJ	_
presiden	presiden	NOUN	Number=Sing
ia	ia	PRON	Number=Sing|Person=3|PronType=Prs
ia	_	PRON	Number=Sing|Person=3|PronType=Prs
mengizinkan	izin	VERB	Mood=Ind|Voice=Act
imigran	imigran	NOUN	Number=Sing
legal	legal	ADJ	_
dalam	dalam	ADP	_
dalam	dalam	NOUN	Number=Sing
dalam	dalam	SCONJ	_
dalam	dalam	ADJ	_
jumlah	jumlah	NOUN	Number=Sing
sangat	sangat	ADV	_
besar	besar	ADJ	_
berdasarkan	dasar	VERB	Mood=Ind|Voice=Act
sistem	sistem	NOUN	Number=Sing
merit	merit	NOUN	Number=Sing
Jadi	jadi	ADV	_
saya	saya	PRON	Number=Sing|Person=1|PronType=Prs
saya	saya	PRON	Number=Sing|Person=1|Poss=Yes|PronType=Prs
suka	suka	VERB	Mood=Ind|Voice=Act
menaruh	taruh	VERB	Mood=Ind|Voice=Act
beban	beban	NOUN	Number=Sing
pun	pun	PART	_
Anda	anda	PRON	Number=Sing|Person=2|PronType=Prs
Anda	anda	PRON	Number=Sing|Person=2|Poss=Yes|PronType=Prs
tapi	tetapi	CCONJ	_
tapi	tapi	CCONJ	_
nasib	nasib	NOUN	Number=Sing
republik	republik	NOUN	Number=Sing
ada	ada	VERB	Mood=Ind|Voice=Act
ada	ada	NOUN	Number=Sing
pundak	pundak	NOUN	Number=Sing
ucap	ucap	VERB	Mood=Ind|Voice=Act
massa	massa	NOUN	Number=Sing
berkumpul	kumpul	VERB	Mood=Ind|Voice=Act
lapangan	lapang	NOUN	Number=Sing
olahraga	olahraga	NOUN	Number=Sing
University	University	PROPN	_
of	of	PROPN	_
North	North	PROPN	_
Carolina	Carolina	PROPN	_
Pengeluaran	keluar	NOUN	Number=Sing
baru	baru	ADJ	_
dipasok	pasok	VERB	Mood=Ind|Voice=Pass
oleh	oleh	ADP	_
oleh	oleh	SCONJ	_
rekening	rekening	NOUN	Number=Sing
bank	bank	NOUN	Number=Sing
gemuk	gemuk	ADJ	_
Clinton	Clinton	PROPN	_
Apa	apa	PRON	PronType=Rel
Apa	apa	PRON	PronType=Int
katakan	kata	VERB	Mood=Ind|Voice=Act
dan	dan	CCONJ	_
apa	apa	PRON	PronType=Rel
apa	apa	PRON	PronType=Int
lakukan	laku	VERB	Mood=Ind|Voice=Act
—	—	PUNCT	_
sesungguhnya	sungguh	ADV	_
luar	luar	NOUN	Number=Sing
biasa	biasa	ADJ	_
Maksimal	maksimal	ADJ	_
diberikan	beri	VERB	Mood=Ind|Voice=Pass
$	$	SYM	_
5.000	5.000	NUM	NumType=Card
per	per	ADP	_
orang	orang	NOUN	Number=Sing
Di	di	ADP	_
Di	Di	PROPN	_
awal	awal	NOUN	Number=Sing
Oktober	Oktober	PROPN	_
tim	tim	NOUN	Number=Sing
menggunakan	guna	VERB	Mood=Ind|Voice=Act
tempat	tempat	NOUN	Number=Sing
tempat	tempat	SCONJ	_
sama	sama	ADJ	_
sama	sama	ADP	_
untuk	untuk	SCONJ	_
untuk	untuk	ADP	_
bertemu	temu	VERB	Mood=Ind|Voice=Act
dengan	dengan	ADP	_
dengan	dengan	SCONJ	_
para	para	DET	Number=Plur|PronType=Ind
pelobi	lobi	NOUN	Number=Sing
teknologi	teknologi	NOUN	Number=Sing
mengundang	undang	VERB	Mood=Ind|Voice=Act
perwakilan	wakil	NOUN	Number=Sing
dari	dari	ADP	_
dari	dari	SCONJ	_
Uber	Uber	PROPN	_
Motion	Motion	PROPN	_
Picture	Picture	PROPN	_
Association	Association	PROPN	_
America	America	PROPN	_
Consumer	Consumer	PROPN	_
Technology	Technology	PROPN	_
grup	grup	NOUN	Number=Sing
lain	lain	ADJ	_
lain	lain	NOUN	Number=Sing
Pertemuan	temu	NOUN	Number=Sing
awalnya	awal	ADV	_
dijadwalkan	jadwal	VERB	Mood=Ind|Voice=Pass
klub	klub	NOUN	Number=Sing
swasta	swasta	ADJ	_
Metropolitan	Metropolitan	PROPN	_
Club	Club	PROPN	_
Washington	Washington	PROPN	_
terletak	letak	VERB	Mood=Ind|Voice=Pass
H	H	PROPN	_
Street	Street	PROPN	_
beberapa	berapa	DET	Number=Plur|PronType=Ind
beberapa	berapa	NOUN	Number=Plur
blok	blok	NOUN	Number=Sing
jauh	jauh	ADJ	_
Mungkin	mungkin	ADV	_
Mungkin	mungkin	ADJ	_
kode	kode	NOUN	Number=Sing
berpakaian	pakai	VERB	Mood=Ind|Voice=Act
terlalu	lalu	ADV	_
sesak	sesak	ADJ	_
Daripada	daripada	SCONJ	_
mengajarkan	ajar	VERB	Mood=Ind|Voice=Act
metode	metode	NOUN	Number=Sing
ilmiah	ilmiah	ADJ	_
unit	unit	NOUN	Number=Sing
terpisah	pisah	ADJ	_
terpisah	pisah	VERB	Mood=Ind|Voice=Pass
misalnya	misal	NOUN	Number=Sing
saja	saja	ADV	_
pelajar	ajar	NOUN	Number=Sing
belajar	ajar	VERB	Mood=Ind|Voice=Act
materi	materi	NOUN	Number=Sing
sains	sains	NOUN	Number=Sing
menerapkan	terap	VERB	Mood=Ind|Voice=Act
Mereka	mereka	PRON	Number=Plur|Person=3|PronType=Prs
menduduki	duduk	VERB	Mood=Ind|Voice=Act
rata-rata	rata	NOUN	Number=Sing
rata-rata	rata	ADJ	_
nasional	nasional	ADJ	_
kelas	kelas	NOUN	Number=Sing
4	4	NUM	NumType=Card
lebih	lebih	ADV	_
lebih	lebih	ADJ	_
baik	baik	ADJ	_
baik	baik	ADV	_
baik	baik	CCONJ	_
8	8	NUM	NumType=Card
Perbandingan	banding	NOUN	Number=Sing
diperlukan	perlu	VERB	Mood=Ind|Voice=Pass
103,7	103,7	NUM	NumType=Card
juta	juta	NUM	NumType=Card
membangun	bangun	VERB	Mood=Ind|Voice=Act
stasiun	stasiun	NOUN	Number=Sing
Metro	Metro	PROPN	_
infill	infill	PROPN	_
NoMa	NoMa	PROPN	_
Kami	kami	PRON	Clusivity=Ex|Number=Plur|Person=1|PronType=Prs
menghadapi	hadap	VERB	Mood=Ind|Voice=Act
banyak	banyak	DET	Number=Plur|PronType=Ind
banyak	banyak	ADJ	_
banyak	banyak	ADV	_
persaingan	saing	NOUN	Number=Sing
kami	kami	PRON	Clusivity=Ex|Number=Plur|Person=1|PronType=Prs
kami	kami	PRON	Clusivity=Ex|Number=Plur|Person=1|Poss=Yes|PronType=Prs
rasa	rasa	VERB	Mood=Ind|Voice=Act
rasa	rasa	NOUN	Number=Sing
transit	transit	NOUN	Number=Sing
bisa	bisa	AUX	_
membantu	bantu	VERB	Mood=Ind|Voice=Act
ujar	ujar	VERB	Mood=Ind|Voice=Act
Joe	Joe	PROPN	_
Sternlieb	Sternlieb	PROPN	_
Georgetown	Georgetown	PROPN	_
BID	BID	PROPN	Abbr=Yes
Studi	studi	NOUN	Number=Sing
kelayakan	layak	NOUN	Number=Sing
memperkirakan	kira	VERB	Mood=Ind|Voice=Act
penumpang	tumpang	NOUN	Number=Sing
menghabiskan	habis	VERB	Mood=Ind|Voice=Act
waktu	waktu	NOUN	Number=Sing
sekitar	kitar	ADV	_
sekitar	kitar	NOUN	Number=Sing
empat	empat	NUM	NumType=Card
menit	menit	NOUN	Number=Sing
menyeberangi	seberang	VERB	Mood=Ind|Voice=Act
Potomac	Potomac	PROPN	_
River	River	PROPN	_
gondola	gondola	NOUN	Number=Sing
Seorang	orang	DET	Number=Sing|PronType=Ind
saksi	saksi	NOUN	Number=Sing
mengatakan	kata	VERB	Mood=Ind|Voice=Act
kepada	kepada	ADP	_
polisi	polisi	NOUN	Number=Sing
korban	korban	NOUN	Number=Sing
telah	telah	AUX	_
telah	telah	ADV	_
menyerang	serang	VERB	Mood=Ind|Voice=Act
tersangka	sangka	NOUN	Number=Sing
bulan	bulan	NOUN	Number=Sing
April	April	PROPN	_
Ada	ada	VERB	Mood=Ind|Voice=Act
benang	benang	NOUN	Number=Sing
merah	merah	ADJ	_
ditarik	tarik	VERB	Mood=Ind|Voice=Pass
sini	sini	PRON	PronType=Dem
antara	antara	ADP	_
antara	antara	NOUN	Number=Sing
antara	antara	SCONJ	_
pertandingan	tanding	NOUN	Number=Sing
kehidupan	hidup	NOUN	Number=Sing
kita	kita	PRON	Clusivity=In|Number=Plur|Person=1|Poss=Yes|PronType=Prs
kita	kita	PRON	Clusivity=In|Number=Plur|Person=1|PronType=Prs
sehari-hari	hari	NOUN	Number=Sing
Saham	saham	NOUN	Number=Sing
itu	itu	DET	PronType=Dem
itu	itu	PRON	PronType=Dem
naik	naik	VERB	Mood=Ind|Voice=Act
stabil	stabil	ADJ	_
selama	lama	ADP	_
selama	lama	SCONJ	_
bertahun-tahun	tahun	NOUN	Number=Sing
bertahun-tahun	tahun	NOUN	Number=Plur
hanya	hanya	ADV	_
11	11	NUM	NumType=Card
persen	persen	NOUN	Number=Sing
total	total	NOUN	Number=Sing
total	total	ADJ	_
suara	suara	NOUN	Number=Sing
sebelum	belum	ADP	_
sebelum	belum	SCONJ	_
Pemilu	pemilu	NOUN	Abbr=Yes|Number=Sing
tahun	tahun	NOUN	Number=Sing
1996	1996	NUM	NumType=Card
menurut	turut	ADP	_
Biro	Biro	PROPN	_
Sensus	Sensus	PROPN	_
--	--	PUNCT	_
sepertinya	seperti	ADV	_
melonjak	lonjak	VERB	Mood=Ind|Voice=Act
lagi	lagi	ADV	_
Hari	hari	NOUN	Number=Sing
Khanzir	Khanzir	PROPN	_
mungkin	mungkin	AUX	_
mungkin	mungkin	ADV	_
mungkin	mungkin	ADJ	_
adalah	adalah	AUX	_
babi	babi	NOUN	Number=Sing
kesepian	sepi	VERB	Mood=Ind|Voice=Act
dia	dia	PRON	Number=Sing|Person=3|PronType=Prs
selalu	selalu	ADV	PronType=Tot
selalu	_	ADV	PronType=Tot
sendiri	sendiri	ADJ	_
sendiri	sendiri	DET	PronType=Emp
meminta	minta	VERB	Mood=Ind|Voice=Act
bangsa-bangsa	bangsa	NOUN	Number=Plur
mengisi	isi	VERB	Mood=Ind|Voice=Act
kebun	kebun	NOUN	Number=Sing
binatang	binatang	NOUN	Number=Sing
berbagai	bagai	DET	Number=Plur|PronType=Ind
spesies	spesies	NOUN	Number=Sing
termasuk	masuk	VERB	Mood=Ind|Voice=Pass
Saqib	Saqib	PROPN	_
saat	saat	NOUN	Number=Sing
saat	saat	ADV	PronType=Rel
saat	saat	ADV	_
saat	saat	ADP	_
Tn.	Tn.	PROPN	Abbr=Yes
Panvalkar	Panvalkar	PROPN	_
ketika	ketika	ADV	PronType=Rel
merasa	rasa	VERB	Mood=Ind|Voice=Act
harus	harus	AUX	_
meninggalkan	tinggal	VERB	Mood=Ind|Voice=Act
gedung	gedung	NOUN	Number=Sing
Ia	ia	PRON	Number=Sing|Person=3|PronType=Prs
juga	juga	ADV	_
didakwa	dakwa	VERB	Mood=Ind|Voice=Pass
mencoba	coba	VERB	Mood=Ind|Voice=Act
membunuh	bunuh	VERB	Mood=Ind|Voice=Act
putri	putri	NOUN	Number=Sing
berusia	usia	VERB	Mood=Ind|Voice=Act
dua	dua	NUM	NumType=Card
Andre	Andre	PROPN	_
Price	Price	PROPN	_
III	iii	ADJ	NumType=Ord
menekan	tekan	VERB	Mood=Ind|Voice=Act
wajah	wajah	NOUN	Number=Sing
ke	ke	ADP	_
matras	matras	NOUN	Number=Sing
udara	udara	NOUN	Number=Sing
ruang	ruang	NOUN	Number=Sing
keluarga	keluarga	NOUN	Number=Sing
melakukan	laku	VERB	Mood=Ind|Voice=Act
hal	hal	NOUN	Number=Sing
Angel	Angel	PROPN	_
ungkap	ungkap	VERB	Mood=Ind|Voice=Act
"	"	PUNCT	_
Toh	toh	INTJ	_
tetap	tetap	ADV	_
tetap	tetap	ADJ	_
masuk	masuk	VERB	Mood=Ind|Voice=Act
penjara	penjara	NOUN	Number=Sing
semoga	moga	ADV	_
sepadan	padan	ADJ	_
Satu	satu	NUM	NumType=Card
wanita	wanita	NOUN	Number=Sing
Yazidi	Yazidi	PROPN	_
mulai	mulai	VERB	Mood=Ind|Voice=Act
menangis	tangis	VERB	Mood=Ind|Voice=Act
diikuti	ikut	VERB	Mood=Ind|Voice=Pass
satu	satu	NUM	NumType=Card
teman	teman	NOUN	Number=Sing
Osborne	Osborne	PROPN	_
bergabung	gabung	VERB	Mood=Ind|Voice=Act
agensi	agensi	NOUN	Number=Sing
pembicara	bicara	NOUN	Number=Sing
AS	AS	PROPN	Abbr=Yes
setelah	telah	SCONJ	_
setelah	telah	ADP	_
dipecat	pecat	VERB	Mood=Ind|Voice=Pass
Juli	Juli	PROPN	_
Michael	Michael	PROPN	_
Fallon	Fallon	PROPN	_
tanggal	tanggal	NOUN	Number=Sing
pemotongan	potong	NOUN	Number=Sing
baja	baja	NOUN	Number=Sing
pertama	pertama	ADJ	NumType=Ord
mendapatkan	dapat	VERB	Mood=Ind|Voice=Act
investasi	investasi	NOUN	Number=Sing
mengamankan	aman	VERB	Mood=Ind|Voice=Act
ratusan	ratus	NUM	NumType=Card
pekerjaan	kerja	NOUN	Number=Sing
terampil	terampil	ADJ	_
hingga	hingga	ADP	_
hingga	hingga	SCONJ	_
2035	2035	NUM	NumType=Card
Janji	janji	NOUN	Number=Sing
tatanan	tatanan	NOUN	Number=Sing
Angkatan	angkat	NOUN	Number=Sing
Laut	laut	NOUN	Number=Sing
Laut	Laut	PROPN	_
industri	industri	NOUN	Number=Sing
galangan	galang	NOUN	Number=Sing
kapal	kapal	NOUN	Number=Sing
Clyde	Clyde	PROPN	_
dibuat	buat	VERB	Mood=Ind|Voice=Pass
referendum	referendum	NOUN	Number=Sing
kemerdekaan	merdeka	NOUN	Number=Sing
Skotlandia	Skotlandia	PROPN	_
2014	2014	NUM	NumType=Card
Paling	paling	ADV	_
nyata	nyata	ADJ	_
nama	nama	NOUN	Number=Sing
seorang	orang	DET	Number=Sing|PronType=Ind
seorang	orang	NOUN	Number=Sing
selebriti	selebritas	NOUN	Number=Sing
cukup	cukup	ADV	_
langka	langka	ADJ	_
Dan	dan	CCONJ	_
2007	2007	NUM	NumType=Card
puncak	puncak	NOUN	Number=Sing
ketenaran	tenar	NOUN	Number=Sing
(	(	PUNCT	_
Knightley	Knightley	PROPN	_
)	)	PUNCT	_
berada	ada	VERB	Mood=Ind|Voice=Act
50	50	NUM	NumType=Card
teratas	atas	ADJ	Degree=Sup
tiga	tiga	NUM	NumType=Card
kali	kali	NOUN	Number=Sing
lipat	lipat	NOUN	Number=Sing
bayi	bayi	NOUN	Number=Sing
dinamai	nama	VERB	Mood=Ind|Voice=Pass
Keira	Keira	PROPN	_
daripada	daripada	ADP	_
daripada	daripada	SCONJ	_
Kieraa	Kieraa	PROPN	_
Perusahaan	usaha	NOUN	Number=Sing
Korea	Korea	PROPN	_
Selatan	Selatan	PROPN	_
Selatan	selatan	NOUN	Number=Sing
berpikir	pikir	VERB	Mood=Ind|Voice=Act
menyalahkan	salah	VERB	Mood=Ind|Voice=Act
kerusakan	rusak	NOUN	Number=Sing
baterai	baterai	NOUN	Number=Sing
mengganti	ganti	VERB	Mood=Ind|Voice=Act
komponen	komponen	NOUN	Number=Sing
pihak	pihak	NOUN	Number=Sing
ketiga	tiga	ADJ	NumType=Ord
ketiga	tiga	NUM	NumType=Card
Beberapa	berapa	DET	PronType=Ind
analis	analis	NOUN	Number=Sing
menyarankan	saran	VERB	Mood=Ind|Voice=Act
Huawei	Huawai	PROPN	_
paling	paling	ADV	_
ditempatkan	tempat	VERB	Mood=Ind|Voice=Pass
mengambil	ambil	VERB	Mood=Ind|Voice=Act
keuntungan	untung	NOUN	Number=Sing
kemunduran	mundur	NOUN	Number=Sing
Samsung	Samsung	PROPN	_
Ponsel	ponsel	NOUN	Number=Sing
Mate	Mate	PROPN	_
9	9	NUM	NumType=Card
memiliki	milik	VERB	Mood=Ind|Voice=Act
antarmuka	antarmuka	NOUN	Number=Sing
kecerdasan	cerdas	NOUN	Number=Sing
buatan	buat	NOUN	Number=Sing
Google	Google	PROPN	_
Assistant	Assistant	PROPN	_
atau	atau	CCONJ	_
Siri	Siri	PROPN	_
Apple	Apple	PROPN	_
ahli	ahli	NOUN	Number=Sing
perjalanan	jalan	NOUN	Number=Sing
mengingatkan	ingat	VERB	Mood=Ind|Voice=Act
internet	internet	NOUN	Number=Sing
pesawat	pesawat	NOUN	Number=Sing
sering	sering	ADV	_
dapat	dapat	AUX	_
diandalkan	andal	VERB	Mood=Ind|Voice=Pass
kemungkinan	mungkin	ADV	_
kemungkinan	mungkin	NOUN	Number=Sing
mempengaruhi	pengaruh	VERB	Mood=Ind|Voice=Act
pilihan	pilih	NOUN	Number=Sing
maskapai	maskapai	NOUN	Number=Sing
penerbangan	terbang	NOUN	Number=Sing
BA	BA	PROPN	Abbr=Yes
IAG	IAG	PROPN	Abbr=Yes
sudah	sudah	AUX	_
memecahkan	pecah	VERB	Mood=Ind|Voice=Act
menawarkan	tawar	VERB	Mood=Ind|Voice=Act
sesuatu	suatu	PRON	PronType=Ind
BBC	BBC	PROPN	Abbr=Yes
menjadi	jadi	VERB	Mood=Ind|Voice=Act
tanggung	tanggung	NOUN	Number=Sing
jawab	jawab	NOUN	Number=Sing
jawab	jawab	VERB	Mood=Ind|Voice=Act
merek	merek	NOUN	Number=Sing
memutuskan	putus	VERB	Mood=Ind|Voice=Act
kah	kah	PART	_
membebankan	beban	VERB	Mood=Ind|Voice=Act
biaya	biaya	NOUN	Number=Sing
akses	akses	NOUN	Number=Sing
Sebagian	bagi	NOUN	Number=Sing
Sebagian	bagi	DET	PronType=Ind
mendapati	dapat	VERB	Mood=Ind|Voice=Act
wi-fi	wi-fi	NOUN	Number=Sing
bandara	bandara	NOUN	Number=Sing
berguna	guna	VERB	Mood=Ind|Voice=Act
mengirim	kirim	VERB	Mood=Ind|Voice=Act
email	email	NOUN	Number=Sing
Kadang	kadang	ADV	PronType=Ind
kala	kala	NOUN	Number=Sing
kekuatan	kuat	NOUN	Number=Sing
super	super	ADJ	_
Skema	skema	NOUN	Number=Sing
menghasilkan	hasil	VERB	Mood=Ind|Voice=Act
uang	uang	NOUN	Number=Sing
melalui	lalu	ADP	_
sponsor	sponsor	NOUN	Number=Sing
iklan	iklan	NOUN	Number=Sing
Kursus	kursus	NOUN	Number=Sing
10	10	NUM	NumType=Card
minggu	minggu	NOUN	Number=Sing
disertifikasi	sertifikasi	VERB	Mood=Ind|Voice=Pass
badan	badan	NOUN	Number=Sing
mata-mata	mata	NOUN	Number=Sing
Inggris	Inggris	PROPN	_
GCHQ	GCHQ	PROPN	Abbr=Yes
pakar	pakar	NOUN	Number=Sing
keamanan	aman	NOUN	Number=Sing
mengajukan	aju	VERB	Mood=Ind|Voice=Act
pertanyaan	tanya	NOUN	Number=Sing
perlu	perlu	VERB	Mood=Ind|Voice=Act
perlu	perlu	ADJ	_
kursus	kursus	NOUN	Number=Sing
maksud	maksud	NOUN	Number=Sing
belakang	belakang	NOUN	Number=Sing
Sebelumnya	belum	ADV	_
jet	jet	NOUN	Number=Sing
tersebut	sebut	DET	PronType=Dem
dilihat	lihat	VERB	Mood=Ind|Voice=Pass
blogger	bloger	NOUN	Number=Sing
Tentunya	tentu	ADV	_
Tiongkok	Tiongkok	PROPN	_
menyajikan	saji	VERB	Mood=Ind|Voice=Act
perangkat	perangkat	NOUN	Number=Sing
keras	keras	ADJ	_
militer	militer	NOUN	Number=Sing
helikopter	helikopter	NOUN	Number=Sing
serangan	serang	NOUN	Number=Sing
laut	laut	NOUN	Number=Sing
seiring	iring	SCONJ	_
siap	siap	VERB	Mood=Ind|Voice=Act
pasar	pasar	NOUN	Number=Sing
terbesar	besar	ADJ	Degree=Sup
dunia	dunia	NOUN	Number=Sing
dekade	dekade	NOUN	Number=Sing
berikutnya	ikut	ADJ	_
pameran	pamer	NOUN	Number=Sing
merupakan	rupa	VERB	Mood=Ind|Voice=Act
peluang	luang	NOUN	Number=Sing
bagi	bagi	ADP	_
Beijing	Beijing	PROPN	_
mendemonstrasikan	demonstrasi	VERB	Mood=Ind|Voice=Act
ambisi	ambisi	NOUN	Number=Sing
sipil	sipil	ADJ	_
pertahanan	tahan	NOUN	Number=Sing
Sayangnya	sayang	ADV	_
lagi-lagi	lagi	ADV	_
karena	karena	ADP	_
karena	karena	SCONJ	_
nila	nila	NOUN	Number=Sing
setitik	titik	NOUN	Number=Sing
rusak	rusak	ADJ	_
susu	susu	NOUN	Number=Sing
sebelanga	belanga	NOUN	Number=Sing
Jesse	Jesse	PROPN	_
LaBrocca	LaBrocca	PROPN	_
pendiri	diri	NOUN	Number=Sing
Hack	Hack	PROPN	_
Forums	Forums	PROPN	_
pesan	pesan	NOUN	Number=Sing
menjelaskan	jelas	VERB	Mood=Ind|Voice=Act
mengapa	apa	ADV	PronType=Rel
bagian	bagi	NOUN	Number=Sing
ditutup	tutup	VERB	Mood=Ind|Voice=Pass
Peristiwa	peristiwa	NOUN	Number=Sing
baru-baru	baru	NOUN	Number=Sing
21	21	NUM	NumType=Card
melumpuhkan	lumpuh	VERB	Mood=Ind|Voice=Act
situs-situs	situs	NOUN	Number=Plur
web	web	NOUN	Number=Sing
populer	populer	ADJ	_
Reddit	Reddit	PROPN	_
Twitter	Twitter	PROPN	_
Spotify	Spotify	PROPN	_
serta	serta	CCONJ	_
situs	situs	NOUN	Number=Sing
Analisis	analisis	NOUN	Number=Sing
menyingkapkan	singkap	VERB	Mood=Ind|Voice=Act
digunakan	guna	VERB	Mood=Ind|Voice=Pass
data	data	NOUN	Number=Sing
mengakibatkan	akibat	VERB	Mood=Ind|Voice=Act
gangguan	ganggu	NOUN	Number=Sing
Sebuah	buah	DET	Number=Sing|PronType=Ind
kajian	kaji	NOUN	Number=Sing
PBB	PBB	PROPN	Abbr=Yes
rencana	rencana	NOUN	Number=Sing
mengurangi	kurang	VERB	Mood=Ind|Voice=Act
karbon	karbon	NOUN	Number=Sing
ketinggalan	tinggal	VERB	Mood=Ind|Voice=Act
peningkatan	tingkat	NOUN	Number=Sing
suhu	suhu	NOUN	Number=Sing
global	global	ADJ	_
bawah	bawah	NOUN	Number=Sing
2	2	NUM	NumType=Card
C	c	NOUN	Abbr=Yes
Banyak	banyak	DET	Number=Plur|PronType=Ind
Banyak	banyak	DET	PronType=Ind
ilmuwan	ilmuwan	NOUN	Number=Sing
menghilangkan	hilang	VERB	Mood=Ind|Voice=Act
kini	kini	ADV	_
kini	kini	NOUN	Number=Sing
memenuhi	penuh	VERB	Mood=Ind|Voice=Act
target	target	NOUN	Number=Sing
Paris	Paris	PROPN	_
Kita	kita	PRON	Clusivity=In|Number=Plur|Person=1|PronType=Prs
Kita	kita	PRON	Clusivity=In|Number=Plur|Person=1|Poss=Yes|PronType=Prs
sedang	sedang	AUX	_
sedang	sedang	ADJ	_
bergerak	gerak	VERB	Mood=Ind|Voice=Act
arah	arah	NOUN	Number=Sing
benar	benar	ADJ	_
benar	benar	ADV	_
:	:	PUNCT	_
Perjanjian	Perjanjian	PROPN	_
Perjanjian	janji	NOUN	Number=Sing
melambatkan	lambat	VERB	Mood=Ind|Voice=Act
perubahan	ubah	NOUN	Number=Sing
iklim	iklim	NOUN	Number=Sing
Kigali	Kigali	PROPN	_
HFC	hfc	NOUN	Abbr=Yes
Erik	Erik	PROPN	_
Solheim	Solheim	PROPN	_
kepala	kepala	NOUN	Number=Sing
UN	UN	PROPN	Abbr=Yes
Environment	Environment	PROPN	_
Investasi	investasi	NOUN	Number=Sing
daerah	daerah	NOUN	Number=Sing
6	6	NUM	NumType=Card
%	%	SYM	_
2015	2015	NUM	NumType=Card
221	221	NUM	NumType=Card
miliar	miliar	NUM	NumType=Card
Sangat	sangat	ADV	_
sekali	kali	ADV	_
namun	namun	CCONJ	_
kontribusi	kontribusi	NOUN	Number=Sing
sebesar	besar	NOUN	Number=Sing
1,5	1,5	NUM	NumType=Card
derajat	derajat	NOUN	Number=Sing
Hal	hal	NOUN	Number=Sing
dilakukan	laku	VERB	Mood=Ind|Voice=Pass
lepas	lepas	ADJ	_
pantai	pantai	NOUN	Number=Sing
pesisir	sisir	NOUN	Number=Sing
Meksiko	Meksiko	PROPN	_
Juni	Juni	PROPN	_
Ini	ini	PRON	PronType=Dem
Ini	ini	NOUN	Number=Sing
menempatkan	tempat	VERB	Mood=Ind|Voice=Act
batas-batas	batas	NOUN	Number=Plur
sifat	sifat	NOUN	Number=Sing
lingkungan	lingkung	NOUN	Number=Sing
alih	alih	VERB	Mood=Ind|Voice=Act
bumi	bumi	NOUN	Number=Sing
-	-	PUNCT	_
dinosaurus	dinosaurus	NOUN	Number=Sing
kepunahan	punah	NOUN	Number=Sing
indikasi	indikasi	NOUN	Number=Sing
bahan	bahan	NOUN	Number=Sing
meteoritik	meteoritik	NOUN	Number=Sing
sarat	sarat	ADJ	_
mengandung	kandung	VERB	Mood=Ind|Voice=Act
elemen	elemen	NOUN	Number=Sing
iridium	iridium	NOUN	Number=Sing
Hanya	hanya	ADV	_
70	70	NUM	NumType=Card
tanaman	tanam	NOUN	Number=Sing
ditumbuhkan	tumbuh	VERB	Mood=Ind|Voice=Pass
biji	biji	NOUN	Number=Sing
Bumi	Bumi	PROPN	_
hidup	hidup	VERB	Mood=Ind|Voice=Act
hidup	hidup	NOUN	Number=Sing
17	17	NUM	NumType=Card
biji-biji	biji	NOUN	Number=Plur
angkasa	angkasa	NOUN	Number=Sing
66	66	NUM	NumType=Card
Hasil	hasil	NOUN	Number=Sing
eksperimen	eksperimen	NOUN	Number=Sing
memberikan	beri	VERB	Mood=Ind|Voice=Act
dukungan	dukung	NOUN	Number=Sing
lanjut	lanjut	ADJ	_
roket	roket	NOUN	Number=Sing
diterbangkan	terbang	VERB	Mood=Ind|Voice=Pass
disimpan	simpan	VERB	Mood=Ind|Voice=Pass
Stasiun	Stasiun	PROPN	_
Luar	Luar	PROPN	_
Luar	luar	NOUN	Number=Sing
Angkasa	Angkasa	PROPN	_
Internasional	Internasional	PROPN	_
enam	enam	NUM	NumType=Card
tanpa	tanpa	SCONJ	_
tanpa	tanpa	ADP	_
dampak	dampak	NOUN	Number=Sing
signifikan	signifikan	ADJ	_
terhadap	hadap	ADP	_
kemampuan	mampu	NOUN	Number=Sing
bertunas	tunas	VERB	Mood=Ind|Voice=Act
tumbuh	tumbuh	VERB	Mood=Ind|Voice=Act
RHS	RHS	PROPN	Abbr=Yes
mengumpulkan	kumpul	VERB	Mood=Ind|Voice=Act
komentar	komentar	NOUN	Number=Sing
dikirim	kirim	VERB	Mood=Ind|Voice=Pass
anak-anak	anak	NOUN	Number=Plur
sekolah	sekolah	NOUN	Number=Sing
sekolah	sekolah	VERB	Mood=Ind|Voice=Act
guru-guru	guru	NOUN	Number=Plur
terlibat	libat	VERB	Mood=Ind|Voice=Pass
Masih	masih	ADV	_
faktor	faktor	NOUN	Number=Sing
'	'	PUNCT	_
jijik	jijik	ADJ	_
perihal	perihal	ADP	_
seluruh	seluruh	DET	PronType=Tot
ide	ide	NOUN	Number=Sing
membeli	beli	VERB	Mood=Ind|Voice=Act
mengenakan	kena	VERB	Mood=Ind|Voice=Act
tubuh	tubuh	NOUN	Number=Sing
rambut	rambut	NOUN	Number=Sing
biasanya	biasa	ADV	_
menjalani	jalan	VERB	Mood=Ind|Voice=Act
proses	proses	NOUN	Number=Sing
mandi	mandi	VERB	Mood=Ind|Voice=Act
kimia	kimia	NOUN	Number=Sing
kutikula	kutikula	NOUN	Number=Sing
sepenuhnya	penuh	ADV	_
jelas	jelas	VERB	Mood=Ind|Voice=Act
jelas	jelas	ADV	_
jelas	jelas	ADJ	_
Tarlo	Tarlo	PROPN	_
Sepanjang	panjang	NOUN	Number=Sing
sejarah	sejarah	NOUN	Number=Sing
internasional	internasional	ADJ	_
dimensi	dimensi	NOUN	Number=Sing
politis	politis	ADJ	_
Malam	malam	NOUN	Number=Sing
menjalankan	jalan	VERB	Mood=Ind|Voice=Act
hukuman	hukum	NOUN	Number=Sing
balok	balok	NOUN	Number=Sing
tinggi	tinggi	ADJ	_
tinggi	tinggi	NOUN	Number=Sing
Polisi	polisi	NOUN	Number=Sing
Polisi	Polisi	PROPN	_
lalu-lintas	lalu-lintas	NOUN	Number=Sing
Shenzhen	Shenzhen	PROPN	_
memilih	pilih	VERB	Mood=Ind|Voice=Act
sanksi	sanksi	NOUN	Number=Sing
Siapa	siapa	PRON	PronType=Int
?	?	PUNCT	_
debat	debat	NOUN	Number=Sing
sisi	sisi	NOUN	Number=Sing
Demokratik	Demokratik	PROPN	_
identitas	identitas	NOUN	Number=Sing
laki-laki	laki	NOUN	Number=Sing
kulit	kulit	NOUN	Number=Sing
putih	putih	ADJ	_
Saya	saya	PRON	Number=Sing|Person=1|PronType=Prs
bertanya	tanya	VERB	Mood=Ind|Voice=Act
mengerti	arti	VERB	Mood=Ind|Voice=Act
kenapa	kenapa	SCONJ	_
Trump	Trump	PROPN	_
Tak	tak	PART	Polarity=Neg
semua	semua	DET	PronType=Tot
semua	semua	PRON	PronType=Tot
beranjak	anjak	VERB	Mood=Ind|Voice=Act
melampaui	lampau	VERB	Mood=Ind|Voice=Act
Untungnya	untung	ADV	_
seseorang	orang	PRON	PronType=Ind
Sony	Sony	PROPN	_
Australia	Australia	PROPN	_
bilang	bilang	VERB	Mood=Ind|Voice=Act
Hei	hei	INTJ	_
omong-omong	omong	INTJ	_
kalian	kalian	PRON	Number=Plur|Person=2|PronType=Prs
melihat	lihat	VERB	Mood=Ind|Voice=Act
Pall	Pall	PROPN	_
Seagal	Seagal	PROPN	_
berita	berita	NOUN	Number=Sing
utama	utama	ADJ	_
menggambarkan	gambar	VERB	Mood=Ind|Voice=Act
tindakan	tindak	NOUN	Number=Sing
Rusia	Rusia	PROPN	_
Krimea	Krimea	PROPN	_
dicaplok	caplok	VERB	Mood=Ind|Voice=Pass
akal	akal	NOUN	Number=Sing
Gemar	gemar	ADJ	_
bermain	main	VERB	Mood=Ind|Voice=Act
gitar	gitar	NOUN	Number=Sing
konser	konser	NOUN	Number=Sing
sana	sana	PRON	PronType=Dem
nenek	nenek	NOUN	Number=Sing
berasal	asal	VERB	Mood=Ind|Voice=Act
Vladivostok	Vladivostok	PROPN	_
Timur	Timur	PROPN	_
Jauh	Jauh	PROPN	_
terakhir	akhir	ADJ	Degree=Sup
mengunjungi	kunjung	VERB	Mood=Ind|Voice=Act
Kamchatka	Kamchatka	PROPN	_
Sakhalin	Sakhalin	PROPN	_
September	September	PROPN	_
diberi	beri	VERB	Mood=Ind|Voice=Pass
kebangsaan	bangsa	NOUN	Number=Sing
Serbia	Serbia	PROPN	_
mendirikan	diri	VERB	Mood=Ind|Voice=Act
bela	bela	NOUN	Number=Sing
diri	diri	PRON	Number=Sing
diri	diri	PRON	PronType=Prs|Reflex=Yes
ibu	ibu	NOUN	Number=Sing
kota	kota	NOUN	Number=Sing
Beograd	Beograd	PROPN	_
juru	juru	NOUN	Number=Sing
bicara	bicara	VERB	Mood=Ind|Voice=Act
Associated	Associated	PROPN	_
Press	Press	PROPN	_
adu	adu	VERB	Mood=Ind|Voice=Act
mulut	mulut	NOUN	Number=Sing
pertengkaran	tengkar	NOUN	Number=Sing
dilaporkan	lapor	VERB	Mood=Ind|Voice=Pass
cedera	cedera	ADJ	_
Cuaron	Cuaron	PROPN	_
film	film	NOUN	Number=Sing
Gravity	Gravity	PROPN	_
memenangkan	menang	VERB	Mood=Ind|Voice=Act
Oscar	Oscar	PROPN	_
lokasi	lokasi	NOUN	Number=Sing
syuting	syuting	NOUN	Number=Sing
insiden	insiden	NOUN	Number=Sing
Menurut	turut	ADP	_
departemen	departemen	NOUN	Number=Sing
kepolisian	polisi	NOUN	Number=Sing
perkelahian	kelahi	NOUN	Number=Sing
pecah	pecah	VERB	Mood=Ind|Voice=Act
sekelompok	kelompok	NOUN	Number=Sing
...	...	PUNCT	_
menyatakan	nyata	VERB	Mood=Ind|Voice=Act
otoritas	otoritas	NOUN	Number=Sing
distrik	distrik	NOUN	Number=Sing
tiba	tiba	VERB	Mood=Ind|Voice=Act
Selasa	Selasa	PROPN	_
Para	para	DET	Number=Plur|PronType=Ind
peneliti	teliti	NOUN	Number=Sing
menyelidiki	selidik	VERB	Mood=Ind|Voice=Act
potensi	potensi	NOUN	Number=Sing
kontrasepsi	kontrasepsi	NOUN	Number=Sing
hormonal	hormonal	ADJ	_
pria	pria	NOUN	Number=Sing
20	20	NUM	NumType=Card
menambahkan	tambah	VERB	Mood=Ind|Voice=Act
langkah	langkah	NOUN	Number=Sing
panjang	panjang	ADJ	_
panjang	panjang	NOUN	Number=Sing
menemukan	temu	VERB	Mood=Ind|Voice=Act
kombinasi	kombinasi	NOUN	Number=Sing
tepat	tepat	ADJ	_
MLA	mla	NOUN	Abbr=Yes
berpegang	pegang	VERB	Mood=Ind|Voice=Act
teguh	teguh	ADJ	_
keyakinan	yakin	NOUN	Number=Sing
agama	agama	NOUN	Number=Sing
menentang	tentang	VERB	Mood=Ind|Voice=Act
legislasi	legislasi	NOUN	Number=Sing
menganalisis	analisis	VERB	Mood=Ind|Voice=Act
DNA	DNA	PROPN	Abbr=Yes
tumor	tumor	NOUN	Number=Sing
penyebab	sebab	NOUN	Number=Sing
dasar	dasar	NOUN	Number=Sing
kanker	kanker	NOUN	Number=Sing
menunjukkan	tunjuk	VERB	Mood=Ind|Voice=Act
hubungan	hubung	NOUN	Number=Sing
langsung	langsung	ADJ	_
rokok	rokok	NOUN	Number=Sing
diisap	isap	VERB	Mood=Ind|Voice=Pass
seumur	umur	NOUN	Number=Sing
mutasi	mutasi	NOUN	Number=Sing
pola	pola	NOUN	Number=Sing
jaringan	jaring	NOUN	Number=Sing
kandung	kandung	NOUN	Number=Sing
kemih	kemih	NOUN	Number=Sing
terpapar	papar	VERB	Mood=Ind|Voice=Pass
secara	cara	ADP	_
Nn.	Nn.	PROPN	Abbr=Yes
Pugh	Pugh	PROPN	_
menerima	terima	VERB	Mood=Ind|Voice=Act
pengobatan	obat	NOUN	Number=Sing
Rumah	Rumah	NOUN	_
Sakit	Sakit	NOUN	_
Papworth	Papworth	PROPN	_
Addenbrooke	Addenbrooke	PROPN	_
Cambridgeshire	Cambridgeshire	PROPN	_
pemindaian	pindai	NOUN	Number=Sing
paru-paru	paru	NOUN	Number=Sing
kanan	kanan	NOUN	Number=Sing
berkembang	kembang	VERB	Mood=Ind|Voice=Act
persidangan	sidang	NOUN	Number=Sing
Jika	jika	SCONJ	_
Donald	Donald	PROPN	_
pemerintah	perintah	NOUN	Number=Sing
bekerja	kerja	VERB	Mood=Ind|Voice=Act
memajukan	maju	VERB	Mood=Ind|Voice=Act
agenda	agenda	NOUN	Number=Sing
bersama	sama	ADJ	_
bersama	sama	ADP	_
bersama	sama	ADV	_
guna	guna	SCONJ	_
memastikan	pasti	VERB	Mood=Ind|Voice=Act
bisnis	bisnis	NOUN	Number=Sing
kepentingan	penting	NOUN	Number=Sing
warga	warga	NOUN	Number=Sing
Kanada	Kanada	PROPN	_
terwakili	wakil	VERB	Mood=Ind|Voice=Pass
Trudeau	Trudeau	PROPN	_
menyampaikan	sampai	VERB	Mood=Ind|Voice=Act
undangan	undang	NOUN	Number=Sing
ke-45	45	ADJ	NumType=Ord
siapa	siapa	PRON	PronType=Rel
siapa	siapa	PRON	PronType=Int
rilis	rilis	NOUN	Number=Sing
rilis	rilis	VERB	Mood=Ind|Voice=Act
foto	foto	NOUN	Number=Sing
pagi	pagi	NOUN	Number=Sing
B.C.	B.C.	PROPN	Abbr=Yes
jawaban	jawab	NOUN	Number=Sing
jawaban	_	NOUN	Number=Sing
rupanya	rupa	ADV	_
gelandangan	gelandang	NOUN	Number=Sing
kasus	kasus	NOUN	Number=Sing
penusukan	tusuk	NOUN	Number=Sing
fatal	fatal	ADJ	_
gadis	gadis	NOUN	Number=Sing
remaja	remaja	ADJ	_
menengah	tengah	ADJ	_
Abbotsford	Abbotsford	PROPN	_
Klein	Klein	PROPN	_
catatan	catat	NOUN	Number=Sing
kriminal	kriminal	ADJ	_
rincian	rinci	NOUN	Number=Sing
samar	samar	ADJ	_
keberadaan	ada	NOUN	Number=Sing
belakangan	belakang	NOUN	Number=Sing
yakin	yakin	ADJ	_
ikatan	ikat	NOUN	Number=Sing
kedua	dua	NUM	NumType=Card
kedua	dua	ADJ	NumType=Ord
khususnya	khusus	ADV	_
area	area	NOUN	Number=Sing
komunikatif	komunikatif	ADJ	_
mau	mau	VERB	Mood=Ind|Voice=Act
berjalan	jalan	VERB	Mood=Ind|Voice=Act
sel	sel	NOUN	Number=Sing
pengadilan	adil	NOUN	Number=Sing
menghadiri	hadir	VERB	Mood=Ind|Voice=Act
pemeriksaan	periksa	NOUN	Number=Sing
Asosiasi	asosiasi	NOUN	Number=Sing
mewakili	wakil	VERB	Mood=Ind|Voice=Act
agen	agen	NOUN	Number=Sing
real	real	X	Foreign=Yes
estate	estate	X	Foreign=Yes
Ontario	Ontario	PROPN	_
masih	masih	ADV	_
melindungi	lindung	VERB	Mood=Ind|Voice=Act
konsumen	konsumen	NOUN	Number=Sing
menghukum	hukum	VERB	Mood=Ind|Voice=Act
didapati	dapat	VERB	Mood=Ind|Voice=Pass
perilaku	perilaku	NOUN	Number=Sing
etis	etis	ADJ	_
ingin	ingin	VERB	Mood=Ind|Voice=Act
penegakan	tegak	NOUN	Number=Sing
penyelidikan	selidik	NOUN	Number=Sing
Real	Real	PROPN	_
Estate	Estate	PROPN	_
Council	Council	PROPN	_
RECO	RECO	PROPN	Abbr=Yes
mengatur	atur	VERB	Mood=Ind|Voice=Act
agen-agen	agen	NOUN	Number=Plur
provinsi	provinsi	NOUN	Number=Sing
Saat	saat	NOUN	Number=Sing
Saat	saat	ADV	PronType=Rel
maksimal	maksimal	ADJ	_
denda	denda	NOUN	Number=Sing
dikenakan	kena	VERB	Mood=Ind|Voice=Pass
25.000	25.000	NUM	NumType=Card
bersikap	sikap	VERB	Mood=Ind|Voice=Act
vokal	vokal	ADV	_
beracun	racun	VERB	Mood=Ind|Voice=Act
kota-kota	kota	NOUN	Number=Plur
demi	demi	ADP	_
menyaksikan	saksi	VERB	Mood=Ind|Voice=Act
kabut	kabut	NOUN	Number=Sing
menyesakkan	sesak	VERB	Mood=Ind|Voice=Act
dada	dada	NOUN	Number=Sing
negara	negara	NOUN	Number=Sing
penghasil	hasil	NOUN	Number=Sing
emisi	emisi	NOUN	Number=Sing
Brasil	Brasil	PROPN	_
Afrika	Afrika	PROPN	_
India	India	PROPN	_
meningkatkan	tingkat	VERB	Mood=Ind|Voice=Act
peran	peran	NOUN	Number=Sing
Guilbeault	Guilbeault	PROPN	_
menunggu	tunggu	VERB	Mood=Ind|Voice=Act
akhir	akhir	NOUN	Number=Sing
masa	masa	NOUN	Number=Sing
jabatan	jabat	NOUN	Number=Sing
ketentuan	tentu	NOUN	Number=Sing
keluar	keluar	VERB	Mood=Ind|Voice=Act
pakta	pakta	NOUN	Number=Sing
Sementara	sementara	ADP	_
sekutu	sekutu	NOUN	Number=Sing
agar	agar	SCONJ	_
disorot	sorot	VERB	Mood=Ind|Voice=Pass
menuduh	tuduh	VERB	Mood=Ind|Voice=Act
meremehkan	remeh	VERB	Mood=Ind|Voice=Act
perempuan	perempuan	NOUN	Number=Sing
minoritas	minoritas	NOUN	Number=Sing
temperamen	temperamen	NOUN	Number=Sing
membuat	buat	VERB	Mood=Ind|Voice=Act
layak	layak	ADJ	_
menjabat	jabat	VERB	Mood=Ind|Voice=Act
Bukan	bukan	PART	Polarity=Neg
butuhkan	butuh	VERB	Mood=Ind|Voice=Act
saudara-saudara	saudara	NOUN	Number=Plur
Istri	istri	NOUN	Number=Sing
Melania	Melania	PROPN	_
tampil	tampil	VERB	Mood=Ind|Voice=Act
sejak	sejak	ADP	_
konvensi	konvensi	NOUN	Number=Sing
Republican	Republican	PROPN	_
Siswa	siswa	NOUN	Number=Sing
Rai	Rai	PROPN	_
mengadakan	ada	VERB	Mood=Ind|Voice=Act
pertemuan	temu	NOUN	Number=Sing
konselor	konselor	NOUN	Number=Sing
membicarakan	bicara	VERB	Mood=Ind|Voice=Act
kata	kata	VERB	Mood=Ind|Voice=Act
kata	kata	NOUN	Number=Sing
penghiburan	hibur	NOUN	Number=Sing
datang	datang	VERB	Mood=Ind|Voice=Act
teman-teman	teman	NOUN	Number=Plur
petaka	petaka	NOUN	Number=Sing
pasien	pasien	NOUN	Number=Sing
penderita	derita	NOUN	Number=Sing
sakit	sakit	ADJ	_
sakit	sakit	NOUN	Number=Sing
Mailis	Mailis	PROPN	_
wawancara	wawancara	NOUN	Number=Sing
Kamis	Kamis	PROPN	_
CBC	CBC	PROPN	Abbr=Yes
News	News	PROPN	_
Dokter	dokter	NOUN	Number=Sing
alat-alat	alat	NOUN	Number=Plur
lembar	lembar	NOUN	Number=Sing
resep	resep	NOUN	Number=Sing
suntikan	suntik	NOUN	Number=Sing
Direktur	Direktur	PROPN	_
Direktur	direktur	NOUN	Number=Sing
Kajian	Kajian	PROPN	_
Kajian	kaji	NOUN	Number=Sing
Independen	Independen	PROPN	_
Gerry	Gerry	PROPN	_
McNeilly	McNeilly	PROPN	_
menetapkan	tetap	VERB	Mood=Ind|Voice=Act
pertanyaan-pertanyaan	tanya	NOUN	Number=Plur
menggelisahkan	gelisah	VERB	Mood=Ind|Voice=Act
diajukan	aju	VERB	Mood=Ind|Voice=Pass
bagaimana	bagaimana	ADV	PronType=Rel
bagaimana	bagaimana	ADV	PronType=Int
berinteraksi	interaksi	VERB	Mood=Ind|Voice=Act
pribumi	pribumi	NOUN	Number=Sing
Facebook	Facebook	PROPN	_
menghasut	hasut	VERB	Mood=Ind|Voice=Act
diduga	duga	VERB	Mood=Ind|Voice=Pass
utara	utara	NOUN	Number=Sing
eksekutif	eksekutif	NOUN	Number=Sing
eksekutif	eksekutif	ADJ	_
disebut	sebut	VERB	Mood=Ind|Voice=Pass
gaji	gaji	NOUN	Number=Sing
kinerja	kinerja	NOUN	Number=Sing
atas	atas	ADP	_
atas	atas	NOUN	Number=Sing
keberhasilan	hasil	NOUN	Number=Sing
mencapai	capai	VERB	Mood=Ind|Voice=Act
ekspektasi	ekspektasi	NOUN	Number=Sing
berbagi	bagi	VERB	Mood=Ind|Voice=Act
perkiraan	kira	NOUN	Number=Sing
masing-masing	masing-masing	NOUN	Number=Sing
masing-masing	masing-masing	DET	PronType=Tot
15.000	15.000	NUM	NumType=Card
Anggaran	anggar	NOUN	Number=Sing
tahunan	tahun	NOUN	Number=Sing
1,4	1,4	NUM	NumType=Card
mempekerjakan	kerja	VERB	Mood=Ind|Voice=Act
6.000	6.000	NUM	NumType=Card
Pemerintah	perintah	NOUN	Number=Sing
Pemerintah	pemerintah	NOUN	Number=Sing
federal	federal	ADJ	_
proaktif	proaktif	ADJ	_
melaporkan	lapor	VERB	Mood=Ind|Voice=Act
level	level	NOUN	Number=Sing
2013	2013	NUM	NumType=Card
kedaluwarsa	kedaluwarsa	ADJ	_
Total	total	NOUN	Number=Sing
bonus	bonus	NOUN	Number=Sing
kira-kira	kira	ADV	_
2016	2016	NUM	NumType=Card
Gomery	Gomery	PROPN	_
memimpin	pimpin	VERB	Mood=Ind|Voice=Act
komisi	komisi	NOUN	Number=Sing
pencarian	cari	NOUN	Number=Sing
informasi	informasi	NOUN	Number=Sing
skandal	skandal	NOUN	Number=Sing
2004	2004	NUM	NumType=Card
2006	2006	NUM	NumType=Card
badan-badan	badan	NOUN	Number=Plur
penting	penting	ADJ	_
memulihkan	pulih	VERB	Mood=Ind|Voice=Act
kepercayaan	percaya	NOUN	Number=Sing
publik	publik	NOUN	Number=Sing
aturan	atur	NOUN	Number=Sing
hukum	hukum	NOUN	Number=Sing
Itu	itu	PRON	PronType=Dem
mengarah	arah	VERB	Mood=Ind|Voice=Act
pengungkapan	ungkap	NOUN	Number=Sing
sedikitnya	sedikit	ADV	_
jurnalis	jurnalis	NOUN	Number=Sing
Quebec	Quebec	PROPN	_
operasi	operasi	NOUN	Number=Sing
pengawasan	awas	NOUN	Number=Sing
Tidak	tidak	PART	Polarity=Neg
boleh	boleh	AUX	_
istimewa	istimewa	ADJ	_
kelihatan	lihat	VERB	Mood=Ind|Voice=Act
individu	individu	NOUN	Number=Sing
organisasi	organisasi	NOUN	Number=Sing
finansial	finansial	ADJ	_
politisi	politisi	NOUN	Number=Sing
partai	partai	NOUN	Number=Sing
politik	politik	NOUN	Number=Sing
pedoman	pedoman	NOUN	Number=Sing
Hakim	hakim	NOUN	Number=Sing
penipuan	tipu	NOUN	Number=Sing
pelanggaran	langgar	NOUN	Number=Sing
akhirnya	akhir	ADV	_
Senat	Senat	PROPN	_
membebaskan	bebas	VERB	Mood=Ind|Voice=Act
Duffy	Duffy	PROPN	_
dakwaan	dakwa	NOUN	Number=Sing
Telepon	telepon	NOUN	Number=Sing
seluler	seluler	NOUN	Number=Sing
berfungsi	fungsi	VERB	Mood=Ind|Voice=Act
sekadar	kadar	ADV	_
telepon	telepon	NOUN	Number=Sing
dewasa	dewasa	NOUN	Number=Sing
dewasa	dewasa	ADJ	_
lapor	lapor	VERB	Mood=Ind|Voice=Act
pelanggan	langgan	NOUN	Number=Sing
tak	tak	PART	Polarity=Neg
terbatas	batas	ADJ	_
SaskTel	SaskTel	PROPN	_
Lindsay	Lindsay	PROPN	_
Gay	Gay	PROPN	_
lalu	lalu	VERB	Mood=Ind|Voice=Act
lalu	lalu	SCONJ	_
lalu	lalu	ADP	_
Rogers	Rogers	PROPN	_
memperkenalkan	kenal	VERB	Mood=Ind|Voice=Act
alat	alat	NOUN	Number=Sing
aplikasi	aplikasi	NOUN	Number=Sing
memantau	pantau	VERB	Mood=Ind|Voice=Act
penggunaan	guna	NOUN	Number=Sing
paket	paket	NOUN	Number=Sing
kembali	kembali	VERB	Mood=Ind|Voice=Act
kembali	kembali	ADV	_
Perkiraan	kira	NOUN	Number=Sing
bertepatan	tepat	VERB	Mood=Ind|Voice=Act
persentase	persentase	NOUN	Number=Sing
condo	condo	NOUN	Abbr=Yes
memasuki	masuk	VERB	Mood=Ind|Voice=Act
persewaan	sewa	NOUN	Number=Sing
selesai	selesai	VERB	Mood=Ind|Voice=Act
dibangun	bangun	VERB	Mood=Ind|Voice=Pass
mengindikasikan	indikasi	VERB	Mood=Ind|Voice=Act
dimainkan	main	VERB	Mood=Ind|Voice=Pass
investor	investor	NOUN	Number=Sing
domestik	domestik	ADJ	_
perumahan	rumah	NOUN	Number=Sing
GTA	GTA	PROPN	Abbr=Yes
punggung	punggung	NOUN	Number=Sing
mual	mual	ADJ	_
produk	produk	NOUN	Number=Sing
tidur	tidur	VERB	Mood=Ind|Voice=Act
lelap	lelap	ADV	_
sepanjang	panjang	NOUN	Number=Sing
malam	malam	NOUN	Number=Sing
Dietrich	Dietrich	PROPN	_
kantor	kantor	NOUN	Number=Sing
pusat	pusat	NOUN	Number=Sing
perusahaan	usaha	NOUN	Number=Sing
Denver	Denver	PROPN	_
Colorado	Colorado	PROPN	_
mana	mana	PRON	PronType=Rel
mana	mana	PRON	PronType=Int
ganja	ganja	NOUN	Number=Sing
dijual	jual	VERB	Mood=Ind|Voice=Pass
kerangka	rangka	NOUN	Number=Sing
legislatif	legislatif	ADJ	_
asal-muasal	asal	NOUN	Number=Sing
obat	obat	NOUN	Number=Sing
tradisional	tradisional	ADJ	_
pengubah	ubah	NOUN	Number=Sing
suasana	suasana	NOUN	Number=Sing
hati	hati	NOUN	Number=Sing
perusahaan-perusahaan	usaha	NOUN	Number=Plur
bertanya-tanya	tanya	VERB	Mood=Ind|Voice=Act
Besi	besi	NOUN	Number=Sing
dibutuhkan	butuh	VERB	Mood=Ind|Voice=Pass
memproduksi	produksi	VERB	Mood=Ind|Voice=Act
hemoglobin	hemoglobin	NOUN	Number=Sing
protein	protein	NOUN	Number=Sing
ditemukan	temu	VERB	Mood=Ind|Voice=Pass
darah	darah	NOUN	Number=Sing
bertanggung	tanggung	VERB	Mood=Ind|Voice=Act
mengangkut	angkut	VERB	Mood=Ind|Voice=Act
oksigen	oksigen	NOUN	Number=Sing
Periode	periode	NOUN	Number=Sing
tunggu	tunggu	VERB	Mood=Ind|Voice=Act
delapan	delapan	NUM	NumType=Card
normal	normal	ADJ	_
cadangan	cadang	NOUN	Number=Sing
besi	besi	NOUN	Number=Sing
rendah	rendah	ADJ	_
keseluruhan	seluruh	NOUN	Number=Sing
Canadian	Canadian	PROPN	_
Blood	Blood	PROPN	_
Services	Services	PROPN	_
CBS	CBS	PROPN	Abbr=Yes
Pedoman	pedoman	NOUN	Number=Sing
berarti	arti	VERB	Mood=Ind|Voice=Act
donor	donor	NOUN	Number=Sing
berawal	awal	VERB	Mood=Ind|Voice=Act
USG	usg	NOUN	Abbr=Yes
rutin	rutin	NOUN	Number=Sing
rumit	rumit	ADJ	_
hamil	hamil	VERB	Mood=Ind|Voice=Act
Margaret	Margaret	PROPN	_
Boemer	Boemer	PROPN	_
Plano	Plano	PROPN	_
Texas	Texas	PROPN	_
tahu	tahu	VERB	Mood=Ind|Voice=Act
kandungan	kandung	NOUN	Number=Sing
menderita	derita	VERB	Mood=Ind|Voice=Act
kondisi	kondisi	NOUN	Number=Sing
dibedah	bedah	VERB	Mood=Ind|Voice=Pass
bertahan	tahan	VERB	Mood=Ind|Voice=Act
Sakrokoksigeal	sakrokoksigeal	NOUN	Number=Sing
teratoma	teratoma	NOUN	Number=Sing
lahir	lahir	VERB	Mood=Ind|Voice=Act
tulang	tulang	NOUN	Number=Sing
ekor	ekor	NOUN	Number=Sing
setiap	tiap	DET	PronType=Tot
35.000	35.000	NUM	NumType=Card
kelahiran	lahir	NOUN	Number=Sing
tutup	tutup	VERB	Mood=Ind|Voice=Act
usia	usia	NOUN	Number=Sing
84	84	NUM	NumType=Card
Dia	dia	PRON	Number=Sing|Person=3|PronType=Prs
penyayang	sayang	NOUN	Number=Sing
mengagumkan	kagum	VERB	Mood=Ind|Voice=Act
jejak	jejak	NOUN	Number=Sing
sastra	sastra	NOUN	Number=Sing
cerita-cerita	cerita	NOUN	Number=Plur
Bono	Bono	PROPN	_
salah	salah	ADJ	_
Leive	Leive	PROPN	_
Pada	pada	ADP	_
kuat	kuat	ADJ	_
bullying	bullying	X	Foreign=Yes
positif	positif	ADJ	_
gadis-gadis	gadis	NOUN	Number=Plur
menyelami	selam	VERB	Mood=Ind|Voice=Act
standar	standar	NOUN	Number=Sing
kecantikan	cantik	NOUN	Number=Sing
Suara	suara	NOUN	Number=Sing
menjangkau	jangkau	VERB	Mood=Ind|Voice=Act
Segera	segera	ADV	_
pesta	pesta	NOUN	Number=Sing
resmi	resmi	ADJ	_
dirilis	rilis	VERB	Mood=Ind|Voice=Pass
dipenuhi	penuh	VERB	Mood=Ind|Voice=Pass
komentar-komentar	komentar	NOUN	Number=Plur
menyenangkan	senang	VERB	Mood=Ind|Voice=Act
kelompok	kelompok	NOUN	Number=Sing
penduduk	duduk	NOUN	Number=Sing
asli	asli	ADJ	_
pengkerdilan	kerdil	NOUN	Number=Sing
budaya	budaya	NOUN	Number=Sing
Bangsa	Bangsa	PROPN	_
Pertama	Pertama	PROPN	_
Pertama	pertama	ADJ	NumType=Ord
Tujuan	tuju	NOUN	Number=Sing
acara	acara	NOUN	Number=Sing
dengar	dengar	VERB	Mood=Ind|Voice=Act
pendapat	dapat	NOUN	Number=Sing
CRTC	CRTC	PROPN	Abbr=Yes
respons	respons	NOUN	Number=Sing
pemangku	pangku	NOUN	Number=Sing
masyarakat	masyarakat	NOUN	Number=Sing
umum	umum	ADJ	_
berlaku	laku	VERB	Mood=Ind|Voice=Act
konten	konten	NOUN	Number=Sing
hiburan	hibur	NOUN	Number=Sing
pendidikan	didik	NOUN	Number=Sing
riset	riset	NOUN	Number=Sing
terpenting	penting	ADJ	Degree=Sup
wacana	wacana	NOUN	Number=Sing
Lagi	lagi	ADV	_
pula	pula	ADV	_
bukan	bukan	PART	Polarity=Neg
barang	barang	NOUN	Number=Sing
mewah	mewah	ADJ	_
;	;	PUNCT	_
Serpihan-serpihan	serpih	NOUN	Number=Plur
membentuk	bentuk	VERB	Mood=Ind|Voice=Act
cincin	cincin	NOUN	Number=Sing
khatulistiwa	khatulistiwa	NOUN	Number=Sing
bersama-sama	sama	ADV	_
gravitasi	gravitasi	NOUN	Number=Sing
terjawab	jawab	VERB	Mood=Ind|Voice=Pass
Hillsborough	Hillsborough	PROPN	_
Chapel	Chapel	PROPN	_
meledakkan	ledak	VERB	Mood=Ind|Voice=Act
bom	bom	NOUN	Number=Sing
api	api	NOUN	Number=Sing
markas	markas	NOUN	Number=Sing
Partai	Partai	PROPN	_
Setelah	telah	SCONJ	_
Setelah	telah	ADP	_
mengeluarkan	keluar	VERB	Mood=Ind|Voice=Act
undang-undang	undang	NOUN	Number=Sing
hak	hak	NOUN	Number=Sing
membatasi	batas	VERB	Mood=Ind|Voice=Act
Campbell	Campbell	PROPN	_
safari	safari	NOUN	Number=Sing
gereja-gereja	gereja	NOUN	Number=Plur
mengajari	ajar	VERB	Mood=Ind|Voice=Act
orang-orang	orang	NOUN	Number=Plur
cara	cara	NOUN	Number=Sing
tantangan	tantang	NOUN	Number=Sing
pendaftaran	daftar	NOUN	Number=Sing
mendeteksi	deteksi	VERB	Mood=Ind|Voice=Act
efek	efek	NOUN	Number=Sing
pemilihan	pilih	NOUN	Number=Sing
rentetan	rentet	NOUN	Number=Sing
konflik	konflik	NOUN	Number=Sing
persimpangan	simpang	NOUN	Number=Sing
ide-ide	ide	NOUN	Number=Plur
lama	lama	ADJ	_
Ketidaksesuaian	suai	NOUN	Number=Sing
ekonomi	ekonomi	NOUN	Number=Sing
asing	asing	ADJ	_
seharusnya	harus	AUX	_
ekonom	ekonom	NOUN	Number=Sing
berhati-hati	hati	VERB	Mood=Ind|Voice=Act
bukti	bukti	NOUN	Number=Sing
payah	payah	ADJ	_
kebijakan	bijak	NOUN	Number=Sing
pertumbuhan	tumbuh	NOUN	Number=Sing
PDB	pdb	NOUN	Abbr=Yes
Pemerintahan	perintah	NOUN	Number=Sing
Lincoln	Lincoln	PROPN	_
perkembangan	kembang	NOUN	Number=Sing
kelembagaan	lembaga	NOUN	Number=Sing
perbedaan	beda	NOUN	Number=Sing
Sulla	Sulla	PROPN	_
Roma	Roma	PROPN	_
A.S.	A.S.	PROPN	Abbr=Yes
dibandingkan	banding	VERB	Mood=Ind|Voice=Pass
kesamaan	sama	NOUN	Number=Sing
mendiskreditkan	diskredit	VERB	Mood=Ind|Voice=Act
mengungkapkan	ungkap	VERB	Mood=Ind|Voice=Act
penyesalan	sesal	NOUN	Number=Sing
Tapi	tetapi	CCONJ	_
Tapi	tapi	CCONJ	_
kritik	kritik	NOUN	Number=Sing
Ibu	ibu	NOUN	Number=Sing
Negara	negara	NOUN	Number=Sing
semakin	makin	ADV	_
pedas	pedas	ADJ	_
Karel	Karel	PROPN	_
berempati	empati	VERB	Mood=Ind|Voice=Act
Ketika	ketika	ADV	PronType=Rel
peniru	tiru	NOUN	Number=Sing
John	John	PROPN	_
Domenico	Domenico	PROPN	_
Slate	Slate	PROPN	_
Seiring	iring	SCONJ	_
Seiring	iring	ADP	_
menguat	kuat	VERB	Mood=Ind|Voice=Act
histeria	histeria	NOUN	Number=Sing
Presiden	presiden	NOUN	Number=Sing
Presiden	Presiden	PROPN	_
ancaman	ancam	NOUN	Number=Sing
meresahkan	resah	VERB	Mood=Ind|Voice=Act
omong	omong	NOUN	Number=Sing
kosong	kosong	ADJ	_
benak	benak	NOUN	Number=Sing
artis	artis	NOUN	Number=Sing
Lalu	lalu	SCONJ	_
berhenti	henti	VERB	Mood=Ind|Voice=Act
Produser	produser	NOUN	Number=Sing
Miami	Miami	PROPN	_
Bass	Bass	PROPN	_
menanggapi	tanggap	VERB	Mood=Ind|Voice=Act
sinis	sinis	ADV	_
seni	seni	NOUN	Number=Sing
menggoyangkan	goyang	VERB	Mood=Ind|Voice=Act
pantat	pantat	NOUN	Number=Sing
keprihatinan	prihatin	NOUN	Number=Sing
Dalam	dalam	ADP	_
Dalam	dalam	NOUN	Number=Sing
Zay	Zay	PROPN	_
Zayion	Zayion	PROPN	_
merekam	rekam	VERB	Mood=Ind|Voice=Act
versi	versi	NOUN	Number=Sing
Knuck	Knuck	PROPN	_
If	If	PROPN	_
You	You	PROPN	_
Buck	Buck	PROPN	_
laptop	laptop	NOUN	Number=Sing
rumah	rumah	NOUN	Number=Sing
lagu	lagu	NOUN	Number=Sing
suatu	suatu	DET	Number=Sing|PronType=Ind
saraf	saraf	NOUN	Number=Sing
terhubung	hubung	VERB	Mood=Ind|Voice=Pass
menggeliat	geliat	VERB	Mood=Ind|Voice=Act
loop	loop	X	Foreign=Yes
video	video	NOUN	Number=Sing
buram	buram	ADJ	_
Kebangkitan	bangkit	NOUN	Number=Sing
menggarisbawahi	garis-bawah	VERB	Mood=Ind|Voice=Act
daya	daya	NOUN	Number=Sing
tarik	tarik	NOUN	Number=Sing
artistik	artistik	ADJ	_
sebaliknya	balik	NOUN	Number=Sing
ketidaknyamanan	nyaman	NOUN	Number=Sing
koneksi	koneksi	NOUN	Number=Sing
bermakna	makna	VERB	Mood=Ind|Voice=Act
Akan	akan	AUX	_
aman	aman	ADJ	_
pikir	pikir	VERB	Mood=Ind|Voice=Act
Plato	Plato	PROPN	_
mempercayakan	percaya	VERB	Mood=Ind|Voice=Act
hati-hati	hati	ADJ	_
hati-hati	hati	ADV	_
wali	wali	NOUN	Number=Sing
berpendidikan	didik	VERB	Mood=Ind|Voice=Act
Seperti	seperti	ADP	_
Seperti	seperti	SCONJ	_
kenal	kenal	VERB	Mood=Ind|Voice=Act
begadang	begadang	VERB	Mood=Ind|Voice=Act
membaca	baca	VERB	Mood=Ind|Voice=Act
ngeri	ngeri	ADJ	_
Caplan	Caplan	PROPN	_
menolak	tolak	VERB	Mood=Ind|Voice=Act
retrospektif	retrospektif	ADJ	_
mengutip	kutip	VERB	Mood=Ind|Voice=Act
sepasang	pasang	DET	Number=Plur
cendekia	cendekia	NOUN	Number=Sing
menyebut	sebut	VERB	Mood=Ind|Voice=Act
rasional	rasional	ADJ	_
Firaun	Firaun	PROPN	_
Sungai	sungai	NOUN	Number=Sing
Nil	Nil	PROPN	_
banjir	banjir	VERB	Mood=Ind|Voice=Act
banjir	banjir	NOUN	Number=Sing
nyata-nyata	nyata	ADV	_
2010	2010	NUM	NumType=Card
yayasan	yayasan	NOUN	Number=Sing
merilis	rilis	VERB	Mood=Ind|Voice=Act
edisi	edisi	NOUN	Number=Sing
typeset	typeset	X	Foreign=Yes
Zettel	Zettel	PROPN	_
’s	’s	X	Foreign=Yes
Traum	Traum	PROPN	_
halangan	halang	NOUN	Number=Sing
nuansa	nuansa	NOUN	Number=Sing
draf	draf	NOUN	Number=Sing
offset	offset	X	Foreign=Yes
Berkorespondensi	korespondensi	VERB	Mood=Ind|Voice=Act
Woods	Woods	PROPN	_
menyingkap	singkap	VERB	Mood=Ind|Voice=Act
etimologi	etimologi	NOUN	Number=Sing
Pengabaian	abai	NOUN	Number=Sing
kesehatan	sehat	NOUN	Number=Sing
Alice	Alice	PROPN	_
istri	istri	NOUN	Number=Sing
Setiap	tiap	DET	PronType=Tot
peta	peta	NOUN	Number=Sing
menceritakan	cerita	VERB	Mood=Ind|Voice=Act
kisah	kisah	NOUN	Number=Sing
faktual	faktual	ADJ	_
Yang	yang	PRON	PronType=Rel
dipamerkan	pamer	VERB	Mood=Ind|Voice=Pass
Kementerian	Kementerian	PROPN	_
Pertahanan	Pertahanan	PROPN	_
Pertahanan	pertahanan	NOUN	Number=Sing
membayangkan	bayang	VERB	Mood=Ind|Voice=Act
perang	perang	NOUN	Number=Sing
dingin	dingin	ADJ	_
ujian	uji	NOUN	Number=Sing
Kontituensi	konstituensi	NOUN	Typo=Yes
council	council	X	Foreign=Yes
Kesteven	Kesteven	PROPN	_
62	62	NUM	NumType=Card
pemilih	pilih	NOUN	Number=Sing
mendukung	dukung	VERB	Mood=Ind|Voice=Act
Uni	Uni	PROPN	_
Uni	uni	NOUN	Number=Sing
Eropa	Eropa	PROPN	_
Keterampilan	terampil	NOUN	Number=Sing
wajib	wajib	ADJ	_
pajak	pajak	NOUN	Number=Sing
dirindukan	rindu	VERB	Mood=Ind|Voice=Pass
Christian	Christian	PROPN	_
Wolmar	Wolmar	PROPN	_
menulis	tulis	VERB	Mood=Ind|Voice=Act
sejumlah	jumlah	NOUN	Number=Sing
buku	buku	NOUN	Number=Sing
kereta	kereta	NOUN	Number=Sing
bertarung	tarung	VERB	Mood=Ind|Voice=Act
1	1	NUM	NumType=Card
Desember	Desember	PROPN	_
Liberal	Liberal	PROPN	_
Democrat	Democrat	PROPN	_
pinggiran	pinggir	NOUN	Number=Sing
kaya	kaya	ADJ	_
berharap	harap	VERB	Mood=Ind|Voice=Act
merebut	rebut	VERB	Mood=Ind|Voice=Act
Sarah	Sarah	PROPN	_
Olney	Olney	PROPN	_
mantan	mantan	ADJ	_
tokoh	tokoh	NOUN	Number=Sing
meluncurkan	luncur	VERB	Mood=Ind|Voice=Act
kampanye	kampanye	NOUN	Number=Sing
kursi	kursi	NOUN	Number=Sing
marah	marah	ADJ	_
Lebih	lebih	ADV	_
330	330	NUM	NumType=Card
kru	kru	NOUN	Number=Sing
Vega	Vega	PROPN	_
berpendapat	pendapat	VERB	Mood=Ind|Voice=Act
Orang-orang	orang	NOUN	Number=Plur
terbunuh	bunuh	VERB	Mood=Ind|Voice=Pass
pembangkit	bangkit	NOUN	Number=Sing
listrik	listrik	NOUN	Number=Sing
bertenaga	tenaga	VERB	Mood=Ind|Voice=Act
batu	batu	NOUN	Number=Sing
bara	bara	NOUN	Number=Sing
Badarpur	Badarpur	PROPN	_
tenggara	tenggara	NOUN	Number=Sing
Delhi	Delhi	PROPN	_
beroperasi	operasi	VERB	Mood=Ind|Voice=Act
berikut	ikut	VERB	Mood=Ind|Voice=Act
generator	generator	NOUN	Number=Sing
diesel	diesel	NOUN	Number=Sing
World	World	PROPN	_
Service	Service	PROPN	_
Bush	Bush	PROPN	_
House	House	PROPN	_
Salah	salah	ADJ	_
belasungkawa	belasungkawa	NOUN	Number=Sing
pasti	pasti	ADV	_
menggembirakan	gembira	VERB	Mood=Ind|Voice=Act
Chris	Chris	PROPN	_
kamu	kamu	PRON	Number=Sing|Person=2|PronType=Prs
menghentikan	henti	VERB	Mood=Ind|Voice=Act
ilahi	ilahi	NOUN	Number=Sing
mantel	mantel	NOUN	Number=Sing
terbaik	baik	ADJ	Degree=Sup
dijamin	jamin	VERB	Mood=Ind|Voice=Pass
celah	celah	NOUN	Number=Sing
menebus	tebus	VERB	Mood=Ind|Voice=Act
kekalahan	kalah	NOUN	Number=Sing
mengalahkan	kalah	VERB	Mood=Ind|Voice=Act
hampir	hampir	ADV	_
titik	titik	NOUN	Number=Sing
menyamai	sama	VERB	Mood=Ind|Voice=Act
keinginan	ingin	NOUN	Number=Sing
punya	punya	VERB	Mood=Ind|Voice=Act
permainan	main	NOUN	Number=Sing
tangan	tangan	NOUN	Number=Sing
lembut	lembut	ADJ	_
skuad	skuad	NOUN	Number=Sing
bagus	bagus	ADJ	_
melaju	laju	VERB	Mood=Ind|Voice=Act
memperjuangkan	juang	VERB	Mood=Ind|Voice=Act
menuju	tuju	ADP	_
mengitari	kitar	VERB	Mood=Ind|Voice=Act
Seolah-olah	olah	ADV	_
menjentikkan	jentik	VERB	Mood=Ind|Voice=Act
bola	bola	NOUN	Number=Sing
depan	depan	NOUN	Number=Sing
cangkir	cangkir	NOUN	Number=Sing
menengadah	tengadah	VERB	Mood=Ind|Voice=Act
ditempa	tempa	VERB	Mood=Ind|Voice=Pass
Kejuaraan	Kejuaraan	PROPN	_
Rugby	Rugby	PROPN	_
berusaha	usaha	VERB	Mood=Ind|Voice=Act
habis-habisan	habis	ADV	_
Kemenangan	menang	NOUN	Number=Sing
segera	segera	ADV	_
mengkhawatirkan	khawatir	VERB	Mood=Ind|Voice=Act
sekarang	sekarang	ADV	_
sekarang	sekarang	NOUN	Number=Sing
Ny.	Ny.	PROPN	Abbr=Yes
reputasi	reputasi	NOUN	Number=Sing
pandangan	pandang	NOUN	Number=Sing
mata	mata	NOUN	Number=Sing
elang	elang	NOUN	Number=Sing
dirusak	rusak	VERB	Mood=Ind|Voice=Pass
opini	opini	NOUN	Number=Sing
jemu	jemu	VERB	Mood=Ind|Voice=Act
berbicara	bicara	VERB	Mood=Ind|Voice=Act
penyiksaan	siksa	NOUN	Number=Sing
kesulitan	sulit	VERB	Mood=Ind|Voice=Act
kesulitan	sulit	NOUN	Number=Sing
sandi	sandi	NOUN	Number=Sing
kisah-kisah	kisah	NOUN	Number=Plur
diposting	posting	VERB	Mood=Ind|Voice=Pass
serangkaian	rangkai	DET	Number=Plur
gambar	gambar	NOUN	Number=Sing
teks	teks	NOUN	Number=Sing
Tentu	tentu	ADV	_
Jerman	Jerman	PROPN	_
dipisahkan	pisah	VERB	Mood=Ind|Voice=Pass
rezim	rezim	NOUN	Number=Sing
Nazi	Nazi	PROPN	_
sudut	sudut	NOUN	Number=Sing
jilbab	jilbab	NOUN	Number=Sing
jins	jin	NOUN	Number=Sing
terlihat	lihat	VERB	Mood=Ind|Voice=Pass
sederhana	sederhana	ADJ	_
Artis	artis	NOUN	Number=Sing
satu-satu	satu	NUM	_
menyisihkan	sisih	VERB	Mood=Ind|Voice=Act
Penghargaan	harga	NOUN	Number=Sing
duta	duta	NOUN	Number=Sing
New	New	PROPN	_
York	York	PROPN	_
City	City	PROPN	_
Health	Health	PROPN	_
Hospitals	Hospitals	PROPN	_
Corporation	Corporation	PROPN	_
Harvard	Harvard	PROPN	_
Business	Business	PROPN	_
School	School	PROPN	_
menonton	tonton	VERB	Mood=Ind|Voice=Act
senang	senang	ADJ	_
membiarkan	biar	VERB	Mood=Ind|Voice=Act
kepresidenan	presiden	NOUN	Number=Sing
dimenangkan	menang	VERB	Mood=Ind|Voice=Pass
rasis	rasis	ADJ	_
seksis	seksis	ADJ	_
kualifikasi	kualifikasi	NOUN	Number=Sing
panglima	panglima	NOUN	Number=Sing
tertinggi	tinggi	ADJ	Degree=Sup
Semakin	makin	ADV	_
beralih	alih	VERB	Mood=Ind|Voice=Act
kredit	kredit	NOUN	Number=Sing
…	…	PUNCT	_
pinjaman	pinjam	NOUN	Number=Sing
dikelola	kelola	VERB	Mood=Ind|Voice=Pass
keadaan	ada	NOUN	Number=Sing
mendadak	dadak	ADV	_
menimbulkan	timbul	VERB	Mood=Ind|Voice=Act
masalah	masalah	NOUN	Number=Sing
utang	utang	NOUN	Number=Sing
Alasan	alas	NOUN	Number=Sing
menyediakan	sedia	VERB	Mood=Ind|Voice=Act
perlindungan	lindung	NOUN	Number=Sing
memadai	pada	VERB	Mood=Ind|Voice=Act
pekerja	kerja	NOUN	Number=Sing
dicederai	cedera	VERB	Mood=Ind|Voice=Pass
konteks	konteks	NOUN	Number=Sing
protes	protes	NOUN	Number=Sing
perdagangan	dagang	NOUN	Number=Sing
Secara	cara	ADP	_
teoretis	teoretis	ADJ	_
pasangan	pasang	NOUN	Number=Sing
membuka	buka	VERB	Mood=Ind|Voice=Act
akun	akun	NOUN	Number=Sing
Tesco	Tesco	PROPN	_
3	3	NUM	NumType=Card
£	£	SYM	_
12.000	12.000	NUM	NumType=Card
–	–	PUNCT	_
360	360	NUM	NumType=Card
nasabah	nasabah	NOUN	Number=Sing
Bank	Bank	PROPN	_
Bank	bank	NOUN	Number=Sing
Scotland	Scotland	PROPN	_
saldo	saldo	NOUN	Number=Sing
3.000	3.000	NUM	NumType=Card
opsi	opsi	NOUN	Number=Sing
Vantage	Vantage	PROPN	_
gratis	gratis	ADJ	_
Dengan	dengan	ADP	_
Dengan	dengan	SCONJ	_
teori	teori	NOUN	Number=Sing
mengakses	akses	VERB	Mood=Ind|Voice=Act
kapan	kapan	ADV	PronType=Rel
Bunga	bunga	NOUN	Number=Sing
pemegang	pegang	NOUN	Number=Sing
kartu	kartu	NOUN	Number=Sing
Nectar	Nectar	PROPN	_
meminjam	pinjam	VERB	Mood=Ind|Voice=Act
15.001	15.001	NUM	NumType=Card
19.999	19.999	NUM	NumType=Card
periode	periode	NOUN	Number=Sing
Belerang	belerang	NOUN	Number=Sing
nutrisi	nutrisi	NOUN	Number=Sing
sehat	sehat	ADJ	_
tanah	tanah	NOUN	Number=Sing
tentu	tentu	ADV	_
kekurangan	kurang	VERB	Mood=Ind|Voice=Act
kekurangan	kurang	NOUN	Number=Sing
mineral	mineral	NOUN	Number=Sing
Masuk	masuk	VERB	Mood=Ind|Voice=Act
diperhatikan	hati	VERB	Mood=Ind|Voice=Pass
Memang	memang	ADV	_
mengejutkan	kejut	VERB	Mood=Ind|Voice=Act
awan	awan	NOUN	Number=Sing
hujan	hujan	NOUN	Number=Sing
asam	asam	NOUN	Number=Sing
cerah	cerah	ADJ	_
Dunia	dunia	NOUN	Number=Sing
kemarahan	marah	NOUN	Number=Sing
konyol	konyol	ADJ	_
setidaknya	tidak	ADV	_
hormat	hormat	ADJ	_
terus	terus	ADV	_
memprotes	protes	VERB	Mood=Ind|Voice=Act
fakta	fakta	NOUN	Number=Sing
Ujung-ujung	ujung	NOUN	Number=Plur
mendengar	dengar	VERB	Mood=Ind|Voice=Act
akut	akut	ADJ	_
kesal	kesal	ADJ	_
benar-benar	benar	ADV	_
parah	parah	ADJ	_
Wajar	wajar	ADJ	_
Rocco	Rocco	PROPN	_
Catalano	Catalano	PROPN	_
bernapas	napas	VERB	Mood=Ind|Voice=Act
retro	retro	NOUN	Number=Sing
Aku	aku	PRON	Number=Sing|Person=1|PronType=Prs
sebab	sebab	NOUN	Number=Sing
menenggelamkan	tenggelam	VERB	Mood=Ind|Voice=Act
warna	warna	NOUN	Number=Sing
pindah	pindah	VERB	Mood=Ind|Voice=Act
tinggal	tinggal	VERB	Mood=Ind|Voice=Act
London	London	PROPN	_
Glasgow	Glasgow	PROPN	_
desain	desain	NOUN	Number=Sing
perhiasan	hias	NOUN	Number=Sing
Art	Art	PROPN	_
warna-warna	warna	NOUN	Number=Plur
tropis	tropis	ADJ	_
gelar	gelar	NOUN	Number=Sing
Northampton	Northampton	PROPN	_
mencari	cari	VERB	Mood=Ind|Voice=Act
mencari	_	VERB	Mood=Ind|Voice=Act
bakat-bakat	bakat	NOUN	Number=Plur
Frank	Frank	PROPN	_
model	model	NOUN	Number=Sing
tertawa	tawa	VERB	Mood=Ind|Voice=Act
lanskap	lanskap	NOUN	Number=Sing
menampilkan	tampil	VERB	Mood=Ind|Voice=Act
pakaian	pakai	NOUN	Number=Sing
makanan	makan	NOUN	Number=Sing
Wintour	Wintour	PROPN	_
muncul	muncul	VERB	Mood=Ind|Voice=Act
sebentar	bentar	ADV	_
terekam	rekam	VERB	Mood=Ind|Voice=Pass
memakai	pakai	VERB	Mood=Ind|Voice=Act
kacamata	kacamata	NOUN	Number=Sing
diwawancara	wawancara	VERB	Mood=Ind|Voice=Pass
motocross	motocross	NOUN	Number=Sing
lihat	lihat	VERB	Mood=Ind|Voice=Act
seolah-olah	olah	ADV	_
1970-an	1970	NUM	NumType=Card
bermain-main	main	VERB	Mood=Ind|Voice=Act
sumber	sumber	NOUN	Number=Sing
inspirasi	inspirasi	NOUN	Number=Sing
sesuai	suai	ADJ	_
menarik	tarik	VERB	Mood=Ind|Voice=Act
koleksi	koleksi	NOUN	Number=Sing
bila	bila	SCONJ	_
Sebagus-bagusnya	bagus	ADV	_
naif	naif	ADJ	_
seburuk-buruknya	buruk	ADV	_
meloloskan	lolos	VERB	Mood=Ind|Voice=Act
lobi	lobi	NOUN	Number=Sing
penembakan	tembak	NOUN	Number=Sing
Kepala	kepala	NOUN	Number=Sing
alam	alam	NOUN	Number=Sing
Jeff	Jeff	PROPN	_
Knott	Knott	PROPN	_
heran	heran	ADJ	_
jika	jika	SCONJ	_
pelarangan	larang	NOUN	Number=Sing
pelisensian	lisensi	NOUN	Number=Sing
diperkenalkan	kenal	VERB	Mood=Ind|Voice=Pass
Pendirian	diri	NOUN	Number=Sing
RSPB	RSPB	PROPN	Abbr=Yes
membawa	bawa	VERB	Mood=Ind|Voice=Act
konservasionis	konservasionis	NOUN	Number=Sing
terkemuka	terkemuka	ADJ	_
penulis	tulis	NOUN	Number=Sing
petisi	petisi	NOUN	Number=Sing
Mark	Mark	PROPN	_
Avery	Avery	PROPN	_
presenter	presenter	NOUN	Number=Sing
TV	tv	NOUN	Abbr=Yes|Number=Sing
Packham	Packham	PROPN	_
Katakan	kata	VERB	Mood=Ind|Voice=Act
posisi	posisi	NOUN	Number=Sing
Tentang	tentang	ADP	_
harian	hari	NOUN	Number=Sing
Maroko	Maroko	PROPN	_
middle	middle	X	_
Saturday	Saturday	PROPN	_
negara-negara	negara	NOUN	Number=Plur
maju	maju	VERB	Mood=Ind|Voice=Act
berkesempatan	sempat	VERB	Mood=Ind|Voice=Act
saling	saling	ADV	_
mempertanyakan	tanya	VERB	Mood=Ind|Voice=Act
aktif	aktif	ADJ	_
memikirkan	pikir	VERB	Mood=Ind|Voice=Act
cara-cara	cara	NOUN	Number=Plur
memungkinkan	mungkin	VERB	Mood=Ind|Voice=Act
lingkup	lingkup	NOUN	Number=Sing
litigasi	litigasi	NOUN	Number=Sing
proyek	proyek	NOUN	Number=Sing
sebagaimana	bagaimana	SCONJ	_
sebagaimana	bagaimana	ADP	_
dikutip	kutip	VERB	Mood=Ind|Voice=Pass
Ikan	ikan	NOUN	Number=Sing
kod	kod	NOUN	Number=Sing
Celtic	Celtic	PROPN	_
tumbang	tumbang	VERB	Mood=Ind|Voice=Act
batas	batas	NOUN	Number=Sing
diusulkan	usul	VERB	Mood=Ind|Voice=Pass
pejabat	jabat	NOUN	Number=Sing
pengurangan	kurang	NOUN	Number=Sing
besar-besaran	besar	ADJ	_
dicanangkan	canang	VERB	Mood=Ind|Voice=Pass
ikan	ikan	NOUN	Number=Sing
lidah	lidah	NOUN	Number=Sing
plaice	plaice	NOUN	Number=Sing
megrim	megrim	NOUN	Number=Sing
pollack	pollack	NOUN	Number=Sing
Irlandia	Irlandia	PROPN	_
menyambut	sambut	VERB	Mood=Ind|Voice=Act
pengumuman	umum	NOUN	Number=Sing
Agora	Agora	PROPN	_
mudah	mudah	ADJ	_
mudah	mudah	ADV	_
diakses	akses	VERB	Mood=Ind|Voice=Pass
tambah	tambah	VERB	Mood=Ind|Voice=Act
Dr	Dr	PROPN	Abbr=Yes
Lee	Lee	PROPN	_
anak	anak	NOUN	Number=Sing
mengekspresikan	ekspresi	VERB	Mood=Ind|Voice=Act
ketidaksetujuan	setuju	NOUN	Number=Sing
kebencian	benci	NOUN	Number=Sing
pengasuhan	asuh	NOUN	Number=Sing
modern	modern	ADJ	_
sungguh-sungguh	sungguh	ADV	_
Emicro	Emicro	PROPN	_
keterampilan	terampil	NOUN	Number=Sing
memasang	pasang	VERB	Mood=Ind|Voice=Act
efektif	efektif	ADJ	_
Perusahaan-perusahaan	usaha	NOUN	Number=Plur
firewall	firewall	X	Foreign=Yes
sensitif	sensitif	ADJ	_
berhasil	hasil	VERB	Mood=Ind|Voice=Act
kawat	kawat	NOUN	Number=Sing
berduri	duri	VERB	Mood=Ind|Voice=Act
membingungkan	bingung	VERB	Mood=Ind|Voice=Act
menghalangi	halang	VERB	Mood=Ind|Voice=Act
konsep	konsep	NOUN	Number=Sing
dikenal	kenal	VERB	Mood=Ind|Voice=Pass
saluran	salur	NOUN	Number=Sing
diskusi	diskusi	NOUN	Number=Sing
topik	topik	NOUN	Number=Sing
daftar	daftar	NOUN	Number=Sing
mencakup	cakup	VERB	Mood=Ind|Voice=Act
uni	uni	NOUN	Number=Sing
Perhentian	henti	NOUN	Number=Sing
Bellingham	Bellingham	PROPN	_
persis	persis	ADJ	_
dekat	dekat	ADP	_
dekat	dekat	ADJ	_
perbatasan	batas	NOUN	Number=Sing
Kembali	kembali	VERB	Mood=Ind|Voice=Act
melanjutkan	lanjut	VERB	Mood=Ind|Voice=Act
selatan	selatan	NOUN	Number=Sing
kecil	kecil	ADJ	_
menara	menara	NOUN	Number=Sing
masjid	masjid	NOUN	Number=Sing
menjulang	julang	VERB	Mood=Ind|Voice=Act
penjaga	jaga	NOUN	Number=Sing
bertopi	topi	VERB	Mood=Ind|Voice=Act
mengawasi	awas	VERB	Mood=Ind|Voice=Act
platform	platform	NOUN	Number=Sing
pemeriksa	periksa	NOUN	Number=Sing
roda	roda	NOUN	Number=Sing
palu	palu	NOUN	Number=Sing
pelan-pelan	pelan	ADV	_
mengetuk	ketuk	VERB	Mood=Ind|Voice=Act
menelusuri	telusur	VERB	Mood=Ind|Voice=Act
6.30	6.30	NUM	NumType=Card
lolipop	lolipop	NOUN	Number=Sing
beras	beras	NOUN	Number=Sing
kepompong	kepompong	NOUN	Number=Sing
tawon	tawon	NOUN	Number=Sing
dianggap	anggap	VERB	Mood=Ind|Voice=Pass
lezat	lezat	ADJ	_
kerbau	kerbau	NOUN	Number=Sing
daun	daun	NOUN	Number=Sing
pinang	pinang	NOUN	Number=Sing
kecebong	kecebong	NOUN	Number=Sing
lele	lele	NOUN	Number=Sing
Intervensi	intervensi	NOUN	Number=Sing
berpotensi	potensi	VERB	Mood=Ind|Voice=Act
intervensi	intervensi	NOUN	Number=Sing
berpengaruh	pengaruh	VERB	Mood=Ind|Voice=Act
penyerahan	serah	NOUN	Number=Sing
Hong	Hong	PROPN	_
Kong	Kong	PROPN	_
1997	1997	NUM	NumType=Card
Sumpah	sumpah	NOUN	Number=Sing
melibatkan	libat	VERB	Mood=Ind|Voice=Act
pembuat	buat	NOUN	Number=Sing
sumpah	sumpah	NOUN	Number=Sing
Republik	Republik	PROPN	_
Rakyat	Rakyat	PROPN	_
dipimpin	pimpin	VERB	Mood=Ind|Voice=Pass
pro-Beijing	pro-Beijing	ADJ	_
percaya	percaya	VERB	Mood=Ind|Voice=Act
mencegah	cegah	VERB	Mood=Ind|Voice=Act
kelumpuhan	lumpuh	NOUN	Number=Sing
sementara	sementara	ADP	_
sementara	sementara	NOUN	Number=Sing
sementara	sementara	SCONJ	_
tampak	tampak	VERB	Mood=Ind|Voice=Act
gelombang	gelombang	NOUN	Number=Sing
Kata	kata	VERB	Mood=Ind|Voice=Act
Acara	acara	NOUN	Number=Sing
Andrew	Andrew	PROPN	_
Marr	Marr	PROPN	_
Pemilihan	pilih	NOUN	Number=Sing
jujur	jujur	ADV	_
diinginkan	ingin	VERB	Mood=Ind|Voice=Pass
Mengakhiri	akhir	VERB	Mood=Ind|Voice=Act
karier	karier	NOUN	Number=Sing
mimpi	mimpi	NOUN	Number=Sing
Bermain	main	VERB	Mood=Ind|Voice=Act
seri	seri	ADJ	_
seri	seri	NOUN	Number=Sing
dominasi	dominasi	VERB	Mood=Ind|Voice=Act
dominasi	dominasi	NOUN	Number=Sing
diabaikan	abai	VERB	Mood=Ind|Voice=Pass
berturut-turut	turut	VERB	Mood=Ind|Voice=Act
kelemahan	lemah	NOUN	Number=Sing
kecewa	kecewa	ADJ	_
turun	turun	VERB	Mood=Ind|Voice=Act
poin	poin	NOUN	Number=Sing
tuan	tuan	NOUN	Number=Sing
dialami	alam	VERB	Mood=Ind|Voice=Pass
Andi	Andi	PROPN	_
melawan	lawan	VERB	Mood=Ind|Voice=Act
Benoît	Benoît	PROPN	_
Paire	Paire	PROPN	_
Monte	Monte	PROPN	_
Carlo	Carlo	PROPN	_
keteraturan	atur	NOUN	Number=Sing
tampaknya	_	ADV	_
tampaknya	tampak	ADV	_
Davis	Davis	PROPN	_
Cup	Cup	PROPN	_
berperan	peran	VERB	Mood=Ind|Voice=Act
Survei	survei	NOUN	Number=Sing
kekhawatiran	khawatir	NOUN	Number=Sing
keuangan	uang	NOUN	Number=Sing
Hopley	Hopley	PROPN	_
Duri	duri	NOUN	Number=Sing
risiko	risiko	NOUN	Number=Sing
Berita	berita	NOUN	Number=Sing
merontokkan	rontok	VERB	Mood=Ind|Voice=Act
miliaran	miliar	NUM	NumType=Card
euro	euro	NOUN	Number=Sing
nilai	nilai	NOUN	Number=Sing
VW	VW	PROPN	Abbr=Yes
chief	chief	X	_
executive	executive	X	_
Martin	Martin	PROPN	_
Winterkorn	Winterkorn	PROPN	_
kehilangan	hilang	VERB	Mood=Ind|Voice=Act
kehilangan	hilang	VERB	Mood=Ind|Voice=Pass
tuntutan	tuntut	NOUN	Number=Sing
€	€	SYM	_
16	16	NUM	NumType=Card
persediaan	sedia	NOUN	Number=Sing
Penyelidikan	selidik	NOUN	Number=Sing
dimulai	mulai	VERB	Mood=Ind|Voice=Pass
fokus	fokus	NOUN	Number=Sing
fokus	fokus	VERB	Mood=Ind|Voice=Act
Herbert	Herbert	PROPN	_
Diess	Diess	PROPN	_
pabrik	pabrik	NOUN	Number=Sing
mobil	mobil	NOUN	Number=Sing
dipromosikan	promosi	VERB	Mood=Ind|Voice=Pass
chairman	chairman	X	Foreign=Yes
tersingkap	singkap	VERB	Mood=Ind|Voice=Pass
usaha	usaha	NOUN	Number=Sing
berkontraksi	kontraksi	VERB	Mood=Ind|Voice=Act
July	July	PROPN	_
Brexit	Brexit	PROPN	Abbr=Yes
Brexit	Brexit	PROPN	_
ternyata	nyata	VERB	Mood=Ind|Voice=Pass
malah	malah	ADV	_
bertumbuh	tumbuh	VERB	Mood=Ind|Voice=Act
Bisnis	bisnis	NOUN	Number=Sing
ritel	ritel	NOUN	Number=Sing
grosir	grosir	NOUN	Number=Sing
pembeli	beli	NOUN	Number=Sing
optimis	optimis	ADJ	_
layanan	layan	NOUN	Number=Sing
belanja	belanja	VERB	Mood=Ind|Voice=Act
defisit	defisit	NOUN	Number=Sing
anggaran	anggar	NOUN	Number=Sing
substansial	substansial	ADJ	_
Biaya	biaya	NOUN	Number=Sing
berubah	ubah	VERB	Mood=Ind|Voice=Act
harga	harga	NOUN	Number=Sing
diharapkan	harap	VERB	Mood=Ind|Voice=Pass
musim	musim	NOUN	Number=Sing
meningkat	tingkat	VERB	Mood=Ind|Voice=Act
Tarif	tarif	NOUN	Number=Sing
Eon	Eon	PROPN	_
760	760	NUM	NumType=Card
Avro	Avro	PROPN	_
Energy	Energy	PROPN	_
membayar	bayar	VERB	Mood=Ind|Voice=Act
tarif	tarif	NOUN	Number=Sing
Simple	Simple	PROPN	_
and	and	PROPN	_
Select	Select	PROPN	_
Atau	atau	CCONJ	_
mahal	mahal	ADJ	_
prapembayaran	bayar	NOUN	Number=Sing
keberuntungan	untung	NOUN	Number=Sing
10.000	10.000	NUM	NumType=Card
surat	surat	NOUN	Number=Sing
obligasi	obligasi	NOUN	Number=Sing
mengharapkan	harap	VERB	Mood=Ind|Voice=Act
125	125	NUM	NumType=Card
ya	ya	INTJ	_
Premium	Premium	PROPN	_
Bonds	Bonds	PROPN	_
dibedakan	beda	VERB	Mood=Ind|Voice=Pass
tabungan	tabung	NOUN	Number=Sing
Uang	uang	NOUN	Number=Sing
diinvestasikan	investasi	VERB	Mood=Ind|Voice=Pass
National	National	PROPN	_
Savings	Savings	PROPN	_
&	&	CCONJ	_
Investments	Investments	PROPN	_
pengeluaran	keluar	NOUN	Number=Sing
beramai-ramai	ramai	VERB	Mood=Ind|Voice=Act
memasukkan	masuk	VERB	Mood=Ind|Voice=Act
dana	dana	NOUN	Number=Sing
Diikuti	ikut	VERB	Mood=Ind|Voice=Pass
Aviva	Aviva	PROPN	_
Investors	investors	X	Foreign=Yes
MultiStrategy	multistrategy	X	Foreign=Yes
Target	target	X	Foreign=Yes
Return	return	X	Foreign=Yes
Penghasilan	hasil	NOUN	Number=Sing
arti	arti	NOUN	Number=Sing
uplift	uplift	NOUN	Number=Sing
kejatuhan	jatuh	NOUN	Number=Sing
sterling	sterling	NOUN	Number=Sing
aset	aset	NOUN	Number=Sing
negeri	negeri	NOUN	Number=Sing
Adidas	Adidas	PROPN	_
membersihkan	bersih	VERB	Mood=Ind|Voice=Act
lautan	laut	NOUN	Number=Sing
limbah	limbah	NOUN	Number=Sing
mengambang	ambang	VERB	Mood=Ind|Voice=Act
sepatu	sepatu	NOUN	Number=Sing
Konsumen	konsumen	NOUN	Number=Sing
melejitkan	lejit	VERB	Mood=Ind|Voice=Act
permintaan	minta	NOUN	Number=Sing
laporan	lapor	NOUN	Number=Sing
Januari	Januari	PROPN	_
plastik	plastik	NOUN	Number=Sing
2050	2050	NUM	NumType=Card
kecuali	kecuali	SCONJ	_
kecuali	kecuali	ADP	_
radikal	radikal	ADJ	_
pembuangan	buang	NOUN	Number=Sing
sampah	sampah	NOUN	Number=Sing
bedah	bedah	NOUN	Number=Sing
jenius	jenius	ADJ	_
rehabilitasi	rehabilitasi	NOUN	Number=Sing
pulih	pulih	VERB	Mood=Ind|Voice=Act
Mengingatkan	ingat	VERB	Mood=Ind|Voice=Act
NHS	NHS	PROPN	Abbr=Yes
tekanan	tekan	NOUN	Number=Sing
mendorong	dorong	VERB	Mood=Ind|Voice=Act
Empat	empat	NUM	NumType=Card
cuaca	cuaca	NOUN	Number=Sing
buruk	buruk	ADJ	_
sedangkan	sedang	SCONJ	_
sembilan	sembilan	NUM	NumType=Card
betapa	betapa	SCONJ	_
jadi	jadi	VERB	Mood=Ind|Voice=Act
jadi	jadi	ADV	_
main	main	VERB	Mood=Ind|Voice=Act
Sabtu	Sabtu	PROPN	_
Tahun	tahun	NOUN	Number=Sing
2017	2017	NUM	NumType=Card
memulai	mulai	VERB	Mood=Ind|Voice=Act
RSC	RSC	PROPN	Abbr=Yes
pertengahan	tengah	NOUN	Number=Sing
60-an	60	NUM	NumType=Card
memainkan	main	VERB	Mood=Ind|Voice=Act
tahanan	tahan	NOUN	Number=Sing
pencari	cari	NOUN	Number=Sing
suaka	suaka	NOUN	Number=Sing
Marat	Marat	PROPN	_
/	/	PUNCT	_
Sade	Sade	PROPN	_
Gaun	gaun	NOUN	Number=Sing
Dari	dari	ADP	_
asal	asal	NOUN	Number=Sing
energi	energi	NOUN	Number=Sing
meledak	ledak	VERB	Mood=Ind|Voice=Act
mampu	mampu	AUX	_
kejut	kejut	ADJ	_
Leher	leher	NOUN	Number=Sing
konfrontasi	konfrontasi	NOUN	Number=Sing
menonjolkan	tonjol	VERB	Mood=Ind|Voice=Act
urat-urat	urat	NOUN	Number=Plur
bergetar	getar	VERB	Mood=Ind|Voice=Act
Glenda	Glenda	PROPN	_
bidang	bidang	NOUN	Number=Sing
hangat	hangat	ADJ	_
radio	radio	NOUN	Number=Sing
dideteksi	deteksi	VERB	Mood=Ind|Voice=Pass
Letakkan	letak	VERB	Mood=Ind|Voice=Act
mikrofon	mikrofon	NOUN	Number=Sing
hitungan	hitung	NOUN	Number=Sing
sutradara	sutradara	NOUN	Number=Sing
berdurasi	durasi	VERB	Mood=Ind|Voice=Act
Sinema	sinema	NOUN	Number=Sing
drastis	drastis	ADJ	_
sehingga	sehingga	SCONJ	_
Hollywood	Hollywood	PROPN	_
mengasingkan	asing	VERB	Mood=Ind|Voice=Act
penonton	tonton	NOUN	Number=Sing
pandang	pandang	VERB	Mood=Ind|Voice=Act
penyeimbang	imbang	NOUN	Number=Sing
genting	genting	ADJ	_
pora	pora	NOUN	Number=Sing
riang	riang	ADJ	_
drama	drama	NOUN	Number=Sing
menempelak	tempelak	VERB	Mood=Ind|Voice=Act
tataran	tatar	NOUN	Number=Sing
ringan	ringan	ADJ	_
memang	memang	ADV	_
tontonan	tonton	NOUN	Number=Sing
bioskop	bioskop	NOUN	Number=Sing
Minggu	Minggu	PROPN	_
sore	sore	NOUN	Number=Sing
Bob	Bob	PROPN	_
hasil	hasil	NOUN	Number=Sing
dikatakan	kata	VERB	Mood=Ind|Voice=Pass
mayoritas	mayoritas	NOUN	Number=Sing
pengalaman	alam	NOUN	Number=Sing
garis	garis	NOUN	Number=Sing
kepahlawanan	pahlawan	NOUN	Number=Sing
Doss	Doss	PROPN	_
ranah	ranah	NOUN	Number=Sing
terbayangkan	bayang	VERB	Mood=Ind|Voice=Pass
diprediksi	prediksi	VERB	Mood=Ind|Voice=Pass
karakteristik	karakteristik	NOUN	Number=Sing
memikat	pikat	VERB	Mood=Ind|Voice=Act
Semua	semua	DET	PronType=Tot
petugas	tugas	NOUN	Number=Sing
medis	medis	ADJ	_
bersenjata	senjata	VERB	Mood=Ind|Voice=Act
Millican	Millican	PROPN	_
meninggal	tinggal	VERB	Mood=Ind|Voice=Act
kira	kira	VERB	Mood=Ind|Voice=Act
si	si	DET	PronType=Dem
gugup	gugup	NOUN	Number=Sing
Odi	Odi	PROPN	_
serial	serial	NOUN	Number=Sing
sejauh	jauh	NOUN	Number=Sing
pahlawan	pahlawan	NOUN	Number=Sing
beraksi	aksi	VERB	Mood=Ind|Voice=Act
manusia	manusia	NOUN	Number=Sing
cerita	cerita	NOUN	Number=Sing
menangani	tangan	VERB	Mood=Ind|Voice=Act
Zimmer	Zimmer	PROPN	_
Tetapi	tetapi	CCONJ	_
tindak	tindak	NOUN	Number=Sing
kejahatan	jahat	NOUN	Number=Sing
Cotton	Cotton	PROPN	_
bersumber	sumber	VERB	Mood=Ind|Voice=Act
sejenis	jenis	DET	PronType=Ind
dorongan	dorong	NOUN	Number=Sing
dilahirkan	lahir	VERB	Mood=Ind|Voice=Pass
31	31	NUM	NumType=Card
1832	1832	NUM	NumType=Card
desa	desa	NOUN	Number=Sing
Sunderland	Sunderland	PROPN	_
kebingungan	bingung	NOUN	Number=Sing
berlangsung	langsung	VERB	Mood=Ind|Voice=Act
kilas	kilas	NOUN	Number=Sing
balik	balik	NOUN	Number=Sing
70-an	70	NUM	NumType=Card
flock	flock	NOUN	Number=Sing
melapisi	lapis	VERB	Mood=Ind|Voice=Act
permukaan	muka	NOUN	Number=Sing
berkibar	kibar	VERB	Mood=Ind|Voice=Act
Landmark	landmark	X	Foreign=Yes
South	South	PROPN	_
Tower	Tower	PROPN	_
menugaskan	tugas	VERB	Mood=Ind|Voice=Act
desainer	desainer	NOUN	Number=Sing
interior	interior	NOUN	Number=Sing
Rachel	Rachel	PROPN	_
Winham	Winham	PROPN	_
mendesain	desain	VERB	Mood=Ind|Voice=Act
apartemen	apartemen	NOUN	Number=Sing
tren	tren	NOUN	Number=Sing
berhubungan	hubung	VERB	Mood=Ind|Voice=Act
sentuhan	sentuh	NOUN	Number=Sing
erat	erat	ADJ	_
kaitan	kait	NOUN	Number=Sing
obsesi	obsesi	NOUN	Number=Sing
Dua	dua	NUM	NumType=Card
kemudian	kemudian	ADV	_
Jutting	Jutting	PROPN	_
Pengadilan	Pengadilan	PROPN	_
Pengadilan	adil	NOUN	Number=Sing
Tinggi	Tinggi	PROPN	_
pembunuhan	bunuh	NOUN	Number=Sing
pencegahan	cegah	NOUN	Number=Sing
penguburan	kubur	NOUN	Number=Sing
sah	sah	ADJ	_
tenang	tenang	ADJ	_
jarang	jarang	ADV	_
diukur	ukur	VERB	Mood=Ind|Voice=Pass
seberapa	berapa	ADV	PronType=Rel
berapa	berapa	ADV	PronType=Rel
ikuti	ikut	VERB	Mood=Ind|Voice=Act
Sebagai	bagai	ADP	_
akibat	akibat	NOUN	Number=Sing
akibat	akibat	ADP	_
cepat	cepat	ADJ	_
ceroboh	ceroboh	ADJ	_
mengklik	klik	VERB	Mood=Ind|Voice=Act
tautan	taut	NOUN	Number=Sing
lampiran	lampir	NOUN	Number=Sing
konsekuensi	konsekuensi	NOUN	Number=Sing
mengedukasi	edukasi	VERB	Mood=Ind|Voice=Act
online	online	ADJ	_
Akhirnya	akhir	ADV	_
memudahkan	mudah	VERB	Mood=Ind|Voice=Act
dugaan	duga	NOUN	Number=Sing
berbahaya	bahaya	VERB	Mood=Ind|Voice=Act
bahasa	bahasa	NOUN	Number=Sing
teror	teror	NOUN	Number=Sing
lunak	lunak	ADJ	_
nusa	nusa	NOUN	Number=Sing
bangsa	bangsa	NOUN	Number=Sing
jenis	jenis	NOUN	Number=Sing
eksistensial	eksistensial	ADJ	_
terdaftar	daftar	VERB	Mood=Ind|Voice=Pass
Cukup	cukup	ADV	_
diperebutkan	rebut	VERB	Mood=Ind|Voice=Pass
kekacauan	kacau	NOUN	Number=Sing
nol	nol	NUM	NumType=Card
angkuh	angkuh	ADJ	_
arogan	arogan	ADJ	_
berhak	hak	VERB	Mood=Ind|Voice=Act
peduli	peduli	VERB	Mood=Ind|Voice=Act
racun	racun	NOUN	Number=Sing
5,7	5,7	NUM	NumType=Card
Florida	Florida	PROPN	_
Keunggulan	unggul	NOUN	Number=Sing
ditimbulkan	timbul	VERB	Mood=Ind|Voice=Pass
pemberian	beri	NOUN	Number=Sing
hadir	hadir	VERB	Mood=Ind|Voice=Act
pemungutan	pungut	NOUN	Number=Sing
keunggulan	unggul	NOUN	Number=Sing
16.500	16.500	NUM	NumType=Card
Game	Game	PROPN	_
Thrones	Thrones	PROPN	_
menyelesaikan	selesai	VERB	Mood=Ind|Voice=Act
sisa	sisa	NOUN	Number=Sing
disambut	sambut	VERB	Mood=Ind|Voice=Pass
antusias	antusias	ADJ	_
diumumkan	umum	VERB	Mood=Ind|Voice=Pass
The	The	PROPN	_
Winds	Winds	PROPN	_
Winter	Winter	PROPN	_
A	A	PROPN	_
Dream	Dream	PROPN	_
Spring	Spring	PROPN	_
siswa	siswa	NOUN	Number=Sing
Belanda	Belanda	PROPN	_
mengkomersilkan	komersial	VERB	Mood=Ind|Voice=Act
motor	motor	NOUN	Number=Sing
Harley-Davidson	Harley-Davidson	PROPN	_
tersiar	siar	VERB	Mood=Ind|Voice=Pass
luas	luas	ADJ	_
2020	2020	NUM	NumType=Card
akurat	akurat	ADJ	_
berjangka	jangka	VERB	Mood=Ind|Voice=Act
berdampingan	damping	VERB	Mood=Ind|Voice=Act
menjual	jual	VERB	Mood=Ind|Voice=Act
merasakan	rasa	VERB	Mood=Ind|Voice=Act
pujian	puji	NOUN	Number=Sing
upaya	upaya	NOUN	Number=Sing
mengatasi	atas	VERB	Mood=Ind|Voice=Act
tumpukan	tumpuk	NOUN	Number=Sing
diakumulasi	akumulasi	VERB	Mood=Ind|Voice=Pass
U.S.	U.S.	PROPN	Abbr=Yes
Environmental	Environmental	PROPN	_
Protection	Protection	PROPN	_
Agency	Agency	PROPN	_
memberi	beri	VERB	Mood=Ind|Voice=Act
Selera	selera	NOUN	Number=Sing
terpuaskan	puas	VERB	Mood=Ind|Voice=Pass
ayam	ayam	NOUN	Number=Sing
goreng	goreng	VERB	Mood=Ind|Voice=Act
dulunya	dahulu	ADV	_
alasan	alas	NOUN	Number=Sing
mencintai	cinta	VERB	Mood=Ind|Voice=Act
induk	induk	NOUN	Number=Sing
KFC	KFC	PROPN	Abbr=Yes
Yum	Yum	PROPN	_
Brands	Brands	PROPN	_
bantuan	bantu	NOUN	Number=Sing
American	American	PROPN	_
Civil	Civil	PROPN	_
Liberties	Liberties	PROPN	_
Union	Union	PROPN	_
menantang	tantang	VERB	Mood=Ind|Voice=Act
Mahkamah	Mahkamah	PROPN	_
Agung	Agung	PROPN	_
A.S	A.S	PROPN	Abbr=Yes
ditampilkan	tampil	VERB	Mood=Ind|Voice=Pass
Lovings	Lovings	PROPN	_
Richard	Richard	PROPN	_
peserta	serta	NOUN	Number=Sing
enggan	enggan	ADJ	_
Loving	Loving	PROPN	_
dibuka	buka	VERB	Mood=Ind|Voice=Pass
Mildred	Mildred	PROPN	_
cumbuan	cumbu	NOUN	Number=Sing
tentunya	tentu	ADV	_
meski	meski	SCONJ	_
singkat	singkat	ADJ	_
Selebriti	selebritas	NOUN	Number=Sing
fans	fan	NOUN	Number=Sing
bahkan	bahkan	ADP	_
bahkan	bahkan	SCONJ	_
reporter	reporter	NOUN	Number=Sing
CNN	CNN	PROPN	Abbr=Yes
karakter	karakter	NOUN	Number=Sing
Stranger	Stranger	PROPN	_
Things	Things	PROPN	_
liburan	libur	NOUN	Number=Sing
episode	episode	NOUN	Number=Sing
ku	ku	PRON	Number=Sing|Person=1|Poss=Yes|PronType=Prs
menyala	nyala	VERB	Mood=Ind|Voice=Act
Negan	Negan	PROPN	_
Jeffrey	Jeffrey	PROPN	_
Dean	Dean	PROPN	_
Morgan	Morgan	PROPN	_
kebebasan	bebas	NOUN	Number=Sing
tertentu	tentu	ADJ	_
Norman	Norman	PROPN	_
mengesalkan	kesal	VERB	Mood=Ind|Voice=Act
emosional	emosional	ADJ	_
Episode	episode	NOUN	Number=Sing
Talking	Talking	PROPN	_
Dead	Dead	PROPN	_
peluncuran	luncur	NOUN	Number=Sing
pembangunan	bangun	NOUN	Number=Sing
berlanjut	lanjut	VERB	Mood=Ind|Voice=Act
Barratt	Barratt	PROPN	_
Upaya	upaya	NOUN	Number=Sing
Internet	internet	NOUN	Number=Sing
penggerak	gerak	NOUN	Number=Sing
modal	modal	NOUN	Number=Sing
Untuk	untuk	ADP	_
Untuk	untuk	SCONJ	_
ragu	ragu	ADJ	_
mencoret	coret	VERB	Mood=Ind|Voice=Act
mati	mati	VERB	Mood=Ind|Voice=Act
berwenang	wenang	VERB	Mood=Ind|Voice=Act
pendekatan	dekat	NOUN	Number=Sing
melacak	lacak	VERB	Mood=Ind|Voice=Act
drone	drone	X	Foreign=Yes
Microsoft	Microsoft	PROPN	_
mengumumkan	umum	VERB	Mood=Ind|Voice=Act
Rabu	Rabu	PROPN	_
obrolan	obrol	NOUN	Number=Sing
kerja	kerja	VERB	Mood=Ind|Voice=Act
menyaingi	saing	VERB	Mood=Ind|Voice=Act
komunikasi	komunikasi	NOUN	Number=Sing
Slack	Slack	PROPN	_
emoji	emoji	NOUN	Number=Sing
GIF	gif	NOUN	Abbr=Yes
meme	meme	NOUN	Number=Sing
stiker	stiker	NOUN	Number=Sing
via	via	ADP	_
menghubungkan	hubung	VERB	Mood=Ind|Voice=Act
feed	feed	X	Foreign=Yes
Langkah	langkah	NOUN	Number=Sing
menyoroti	sorot	VERB	Mood=Ind|Voice=Act
pengguna	guna	NOUN	Number=Sing
produktivitas	produktivitas	NOUN	Number=Sing
game	game	NOUN	Number=Sing
Isner	Isner	PROPN	_
tenis	tenis	NOUN	Number=Sing
mengimbangi	imbang	VERB	Mood=Ind|Voice=Act
set	set	NOUN	Number=Sing
memaksa	paksa	VERB	Mood=Ind|Voice=Act
penentuan	tentu	NOUN	Number=Sing
penghormatan	hormat	NOUN	Number=Sing
mengucapkan	ucap	VERB	Mood=Ind|Voice=Act
selamat	selamat	NOUN	Number=Sing
selamat	selamat	ADJ	_
Andy	Andy	PROPN	_
No.	no.	NOUN	Abbr=Yes
No.	No.	NOUN	Number=Sing
prestasi	prestasi	NOUN	Number=Sing
pemain	main	NOUN	Number=Sing
berkebangsaan	bangsa	VERB	Mood=Ind|Voice=Act
Pasangan	pasang	NOUN	Number=Sing
turnamen	turnamen	NOUN	Number=Sing
golf	golf	NOUN	Number=Sing
Utara	Utara	PROPN	_
Utara	utara	NOUN	Number=Sing
baca	baca	VERB	Mood=Ind|Voice=Act
Nine	Nine	PROPN	_
Brisbane	Brisbane	PROPN	_
mengaku	aku	VERB	Mood=Ind|Voice=Act
premier	premier	NOUN	Number=Sing
Snowman	Snowman	PROPN	_
melompati	lompat	VERB	Mood=Ind|Voice=Act
pagar	pagar	NOUN	Number=Sing
memisahkan	pisah	VERB	Mood=Ind|Voice=Act
properti	properti	NOUN	Number=Sing
lumbung	lumbung	NOUN	Number=Sing
berkelakar	kelakar	VERB	Mood=Ind|Voice=Act
jelas-jelas	jelas	ADV	_
Johnny	Johnny	PROPN	_
Carson	Carson	PROPN	_
tangga	tangga	NOUN	Number=Sing
duduk	duduk	VERB	Mood=Ind|Voice=Act
membelakangi	belakang	VERB	Mood=Ind|Voice=Act
berlumpur	lumpur	VERB	Mood=Ind|Voice=Act
parade	parade	NOUN	Number=Sing
Karnaval	Karnaval	PROPN	_
Alejandra	Alejandra	PROPN	_
González	González	PROPN	_
Anaya	Anaya	PROPN	_
direktur	direktur	NOUN	Number=Sing
kreatif	kreatif	ADJ	_
1200	1200	NUM	NumType=Card
relawan	sukarelawan	NOUN	Number=Sing
relawan	rela	NOUN	Number=Sing
menyelamatkan	selamat	VERB	Mood=Ind|Voice=Act
format	format	NOUN	Number=Sing
tradisi	tradisi	NOUN	Number=Sing
jalur	jalur	NOUN	Number=Sing
maglev	maglev	NOUN	Number=Sing
Jepang	Jepang	PROPN	_
Tiket	tiket	NOUN	Number=Sing
F1	F1	PROPN	Abbr=Yes
Situs	situs	NOUN	Number=Sing
Sirkuit	Sirkuit	PROPN	_
Yas	Yas	PROPN	_
Marina	Marina	PROPN	_
mencantumkan	cantum	VERB	Mood=Ind|Voice=Act
segala	segala	DET	PronType=Tot
kemegahan	megah	NOUN	Number=Sing
November	November	PROPN	_
pergi	pergi	VERB	Mood=Ind|Voice=Act
dipicu	picu	VERB	Mood=Ind|Voice=Pass
kemunculan	muncul	NOUN	Number=Sing
gedung-gedung	gedung	NOUN	Number=Plur
MahaNakhon	MahaNakhon	PROPN	_
visioner	visioner	NOUN	Number=Sing
Bangkok	Bangkok	PROPN	_
transformasi	transformasi	NOUN	Number=Sing
kawasan	kawasan	NOUN	Number=Sing
Terkubur	kubur	VERB	Mood=Ind|Voice=Pass
sedalam	dalam	NOUN	Number=Sing
100	100	NUM	NumType=Card
meter	meter	NOUN	Number=Sing
328	328	NUM	NumType=Card
kaki	kaki	NOUN	Number=Sing
Pyongyang	Pyongyang	PROPN	_
komuter	komuter	NOUN	Number=Sing
terdalam	dalam	ADJ	Degree=Sup
Style	Style	PROPN	_
smartphone	smartphone	NOUN	Number=Sing
arsitektur	arsitektur	NOUN	Number=Sing
jembatan	jembatan	NOUN	Number=Sing
sampai	sampai	ADP	_
sampai	sampai	VERB	Mood=Ind|Voice=Act
mengaburkan	kabur	VERB	Mood=Ind|Voice=Act
tua	tua	ADJ	_
perayaan	raya	NOUN	Number=Sing
Didesain	desain	VERB	Mood=Ind|Voice=Pass
Juan	Juan	PROPN	_
Carlos	Carlos	PROPN	_
Salas	Salas	PROPN	_
pemenang	menang	NOUN	Number=Sing
penghargaan	harga	NOUN	Number=Sing
tampilan	tampil	NOUN	Number=Sing
pahatan	pahat	NOUN	Number=Sing
detail	detail	NOUN	Number=Sing
makna	makna	NOUN	Number=Sing
Arsitektur	arsitektur	NOUN	Number=Sing
menjaga	jaga	VERB	Mood=Ind|Voice=Act
kenangan	kenang	NOUN	Number=Sing
Piagam	piagam	NOUN	Number=Sing
pembentukan	bentuk	NOUN	Number=Sing
serikat	serikat	NOUN	Number=Sing
pedagang	dagang	NOUN	Number=Sing
dijalankan	jalan	VERB	Mood=Ind|Voice=Pass
melintasi	lintas	VERB	Mood=Ind|Voice=Act
borough	borough	X	Foreign=Yes
endapan	endap	NOUN	Number=Sing
emas	emas	NOUN	Number=Sing
berlian	berlian	NOUN	Number=Sing
bijih	bijih	NOUN	Number=Sing
mangan	mangan	NOUN	Number=Sing
timbal	timbal	NOUN	Number=Sing
seng	seng	NOUN	Number=Sing
nikel	nikel	NOUN	Number=Sing
kobalt	kobalt	NOUN	Number=Sing
molibdenum	molibdenum	NOUN	Number=Sing
ujung	ujung	NOUN	Number=Sing
barat	barat	NOUN	Number=Sing
taiga	taiga	NOUN	Number=Sing
dominan	dominan	ADJ	_
Siberia	Siberia	PROPN	_
Universiade	Universiade	PROPN	_
Musim	Musim	PROPN	_
Dingin	Dingin	PROPN	_
2019	2019	NUM	NumType=Card
diselenggarakan	selenggara	VERB	Mood=Ind|Voice=Pass
Krasnoyarsk	Krasnoyarsk	PROPN	_
Contoh	contoh	NOUN	Number=Sing
Kepulauan	Kepulauan	PROPN	_
Kepulauan	pulau	PROPN	_
Line	Line	PROPN	_
Pasifik	Pasifik	PROPN	_
Maladewa	Maladewa	PROPN	_
Samudra	Samudra	PROPN	_
Hindia	Hindia	PROPN	_
Granite	Granite	PROPN	_
Seychelles	Seychelles	PROPN	_
Tioman	Tioman	PROPN	_
pulau-pulau	pulau	NOUN	Number=Plur
vulkanik	vulkanis	ADJ	_
Saint	Saint	PROPN	_
Helena	Helena	PROPN	_
pulau	pulau	NOUN	Number=Sing
padang	padang	NOUN	Number=Sing
pasir	pasir	NOUN	Number=Sing
Baja	Baja	PROPN	_
California	California	PROPN	_
Yunani	Yunani	PROPN	_
Athena	Athena	PROPN	_
abad	abad	NOUN	Number=Sing
ke-5	5	ADJ	NumType=Ord
SM	sm	NOUN	Abbr=Yes
SM	SM	NOUN	Abbr=Yes
bergantung	gantung	VERB	Mood=Ind|Voice=Act
impor	impor	NOUN	Number=Sing
biji-bijian	biji	NOUN	Number=Plur
Scythia	Scythia	PROPN	_
persekutuan	sekutu	NOUN	Number=Sing
menguasai	kuasa	VERB	Mood=Ind|Voice=Act
selat	selat	NOUN	Number=Sing
koloni	koloni	NOUN	Number=Sing
Megaria	Megaria	PROPN	_
Byzantium	Byzantium	PROPN	_
Panglima	panglima	PROPN	_
Darius	Darius	PROPN	_
dihormati	hormat	VERB	Mood=Ind|Voice=Pass
Megabazuz	Megabazuz	PROPN	_
penaklukan	takluk	NOUN	Number=Sing
Balkan	Balkan	PROPN	_
Pasukan	pasuk	NOUN	Number=Sing
Pasukan	Pasukan	PROPN	_
Achaemenid	Achaemenid	PROPN	_
menaklukkan	takluk	VERB	Mood=Ind|Voice=Act
Thrace	Thrace	PROPN	_
Paeonian	Paeonian	PROPN	_
512	512	NUM	NumType=Card
511	511	NUM	NumType=Card
raja	raja	NOUN	Number=Sing
Makedonia	Makedonia	PROPN	_
Amyntas	Amyntas	PROPN	_
I	i	ADJ	NumType=Ord
menyerahkan	serah	VERB	Mood=Ind|Voice=Act
bawahan	bawah	NOUN	Number=Sing
Persia	Persia	PROPN	_
Bala	bala	NOUN	Number=Sing
tentara	tentara	NOUN	Number=Sing
multietnis	multietnis	ADJ	_
prajurit	prajurit	NOUN	Number=Sing
Selain	selain	ADP	_
Selain	selain	SCONJ	_
elit	elit	NOUN	Number=Sing
mengawini	kawin	VERB	Mood=Ind|Voice=Act
1912	1912	NUM	NumType=Card
didirikan	diri	VERB	Mood=Ind|Voice=Pass
Athina	Athina	PROPN	_
Film	Film	PROPN	_
Film	film	NOUN	Number=Sing
1916	1916	NUM	NumType=Card
Asty	Asty	PROPN	_
sukses	sukses	ADJ	_
El	El	PROPN	_
Greco	Greco	PROPN	_
disutradarai	sutradara	VERB	Mood=Ind|Voice=Pass
Yannis	Yannis	PROPN	_
Smaragdis	Smaragdis	PROPN	_
1918	1918	NUM	NumType=Card
Franco-Monegasque	Franco-Monegasque	PROPN	_
ditandatangani	tanda-tangan	VERB	Mood=Ind|Voice=Pass
Prancis	Prancis	PROPN	_
Monako	Monako	PROPN	_
Cabang	cabang	NOUN	Number=Sing
terdiri	diri	VERB	Mood=Ind|Voice=Pass
Menteri	menteri	NOUN	Number=Sing
Bagian	bagi	NOUN	Number=Sing
pemerintahan	perintah	NOUN	Number=Sing
lima	lima	NUM	NumType=Card
anggota	anggota	NOUN	Number=Sing
Dewan	dewan	NOUN	Number=Sing
Dewan	Dewan	PROPN	_
mengoperasikan	operasi	VERB	Mood=Ind|Voice=Act
patroli	patroli	NOUN	Number=Sing
Proyek	proyek	NOUN	Number=Sing
reklamasi	reklamasi	NOUN	Number=Sing
memperluas	luas	VERB	Mood=Ind|Voice=Act
Fontvieille	Fontvieille	PROPN	_
prosedur	prosedur	NOUN	Number=Sing
Wales	Wales	PROPN	_
Klasifikasi	klasifikasi	NOUN	Number=Sing
Bergeron	Bergeron	PROPN	_
bentuk	bentuk	NOUN	Number=Sing
klasifikasi	klasifikasi	NOUN	Number=Sing
diterima	terima	VERB	Mood=Ind|Voice=Pass
identifikasi	identifikasi	NOUN	Number=Sing
ramalan	ramal	NOUN	Number=Sing
1950-an	1950	NUM	NumType=Card
klimatologi	klimatologi	NOUN	Number=Sing
sinoptik	sinoptik	ADJ	_
1973	1973	NUM	NumType=Card
Monson	monsun	NOUN	Number=Sing
angin	angin	NOUN	Number=Sing
Berbagai	bagai	DET	Number=Plur|PronType=Ind
suku	suku	NOUN	Number=Sing
Jermanis	Jermanis	PROPN	_
Slavik	Slavik	PROPN	_
Moravia	Moravia	PROPN	_
Migrasi	migrasi	NOUN	Number=Sing
kaum	kaum	NOUN	Number=Sing
Slav	Slav	PROPN	_
ke-6	6	ADJ	NumType=Ord
M	M	NOUN	Abbr=Yes
M	M	PROPN	Abbr=Yes
ke-8	8	ADJ	NumType=Ord
Kota	Kota	PROPN	_
Kota	kota	NOUN	Number=Sing
terbentuk	bentuk	VERB	Mood=Ind|Voice=Pass
Záhorie	Záhorie	PROPN	_
Slowakia	Slowakia	PROPN	_
bagian-bagian	bagi	NOUN	Number=Plur
bagian-bagian	bagian	NOUN	Number=Plur
Lower	Lower	PROPN	_
Austria	Austria	PROPN	_
833	833	NUM	NumType=Card
Great	Great	PROPN	_
Nitra	Nitra	PROPN	_
Raja	raja	NOUN	Number=Sing
Raja	Raja	PROPN	_
Mojmír	Mojmír	PROPN	_
berkuasa	kuasa	VERB	Mood=Ind|Voice=Act
830	830	NUM	NumType=Card
846	846	NUM	NumType=Card
Louis	Louis	PROPN	_
sang	sang	DET	PronType=Dem
menyerbu	serbu	VERB	Mood=Ind|Voice=Act
menggantikan	ganti	VERB	Mood=Ind|Voice=Act
keponakan	keponakan	NOUN	Number=Sing
Rastiz	Rastiz	PROPN	_
St.	St.	PROPN	Abbr=Yes
St.	St.	PROPN	_
Rastislav	Rastislav	PROPN	_
patung	patung	NOUN	Number=Sing
menentukan	tentu	VERB	Mood=Ind|Voice=Act
majelis	majelis	NOUN	Number=Sing
wilayah	wilayah	NOUN	Number=Sing
metropolitan	metropolitan	NOUN	Number=Sing
Islandia	Islandia	PROPN	_
kontrol	kontrol	NOUN	Number=Sing
Denmark	Denmark	PROPN	_
pengaruh	pengaruh	NOUN	Number=Sing
Bahasa	bahasa	NOUN	Number=Sing
Finlandia	Finlandia	PROPN	_
Meänkieli	Meänkieli	PROPN	_
Swedia	Swedia	PROPN	_
Kven	Kven	PROPN	_
Norwegia	Norwegia	PROPN	_
Gradasi	gradasi	NOUN	Number=Sing
konsonan	konsonan	NOUN	Number=Sing
fitur	fitur	NOUN	Number=Sing
dialek	dialek	NOUN	Number=Sing
Sami	Sami	PROPN	_
Caucasus	Caucasus	PROPN	_
Ciscaucasus	Ciscaucasus	PROPN	_
Transcaucasus	Transcaucasus	PROPN	_
Atmosfer	atmosfer	NOUN	Number=Sing
kacau	kacau	ADJ	_
Selama	lama	ADP	_
curah	curah	NOUN	Number=Sing
tetesan	tetes	NOUN	Number=Sing
air	air	NOUN	Number=Sing
menyerap	serap	VERB	Mood=Ind|Voice=Act
melarutkan	larut	VERB	Mood=Ind|Voice=Act
dioksida	dioksida	NOUN	Number=Sing
terbaru	baru	ADJ	Degree=Sup
Pertandingan	Pertandingan	PROPN	_
Olimpiade	Olimpiade	PROPN	_
Panas	Panas	PROPN	_
2008	2008	NUM	NumType=Card
Dibentuk	bentuk	VERB	Mood=Ind|Voice=Pass
tektonik	tektonik	NOUN	Number=Sing
lempeng	lempeng	NOUN	Number=Sing
menciptakan	cipta	VERB	Mood=Ind|Voice=Act
Celah	Celah	PROPN	_
Gunung	Gunung	PROPN	_
Kilimanjaro	Kilimanjaro	PROPN	_
Kenya	Kenya	PROPN	_
gunung	gunung	NOUN	Number=Sing
menyebarkan	sebar	VERB	Mood=Ind|Voice=Act
Islam	Islam	PROPN	_
sabuk	sabuk	NOUN	Number=Sing
sebagian	bagi	NOUN	Number=Sing
sebagian	bagi	DET	PronType=Ind
Bantu	Bantu	PROPN	_
bersentuhan	sentuh	VERB	Mood=Ind|Voice=Act
menganut	anut	VERB	Mood=Ind|Voice=Act
Agama	agama	NOUN	Number=Sing
Tradisional	tradisional	ADJ	_
mengintegrasikan	integrasi	VERB	Mood=Ind|Voice=Act
Kamerun	Kamerun	PROPN	_
memperbaiki	baik	VERB	Mood=Ind|Voice=Act
infrastruktur	infrastruktur	NOUN	Number=Sing
tenaga	tenaga	NOUN	Number=Sing
mengubah	ubah	VERB	Mood=Ind|Voice=Act
paksa	paksa	VERB	Mood=Ind|Voice=Act
paksa	paksa	ADV	_
1961	1961	NUM	NumType=Card
bekas	bekas	ADJ	_
dikuasai	kuasa	VERB	Mood=Ind|Voice=Pass
bersatu	satu	VERB	Mood=Ind|Voice=Act
Federal	Federal	PROPN	_
Temuan	temu	NOUN	Number=Sing
Departemen	departemen	NOUN	Number=Sing
Tenaga	tenaga	NOUN	Number=Sing
Kerja	kerja	VERB	Mood=Ind|Voice=Act
Bentuk	bentuk	NOUN	Number=Sing
Terburuk	buruk	ADJ	Degree=Sup
Anak	anak	NOUN	Number=Sing
56	56	NUM	NumType=Card
5	5	NUM	NumType=Card
14	14	NUM	NumType=Card
53	53	NUM	NumType=Card
7	7	NUM	NumType=Card
Iklim	iklim	NOUN	Number=Sing
Sahel	Sahel	PROPN	_
mirip	mirip	ADJ	_
kurang	kurang	ADV	_
kurang	kurang	ADJ	_
ekstrem	ekstrem	ADJ	_
Gurun	Gurun	PROPN	_
Sahara	Sahara	PROPN	_
Agustus	Agustus	PROPN	_
kelaparan	lapar	NOUN	Number=Sing
melanda	landa	VERB	Mood=Ind|Voice=Act
peradaban	adab	NOUN	Number=Sing
kuno	kuno	ADJ	_
dipengaruhi	pengaruh	VERB	Mood=Ind|Voice=Pass
Posisi	posisi	NOUN	Number=Sing
rute	rute	NOUN	Number=Sing
kolonisasi	kolonisasi	NOUN	Number=Sing
memancing	pancing	VERB	Mood=Ind|Voice=Act
Karena	karena	ADP	_
Karena	karena	SCONJ	_
geologi	geologi	NOUN	Number=Sing
berpusat	pusat	VERB	Mood=Ind|Voice=Act
Mediterania	Mediterania	PROPN	_
cenderung	cenderung	ADJ	_
jalinan	jalin	NOUN	Number=Sing
kadar	kadar	NOUN	Number=Sing
zaman	zaman	NOUN	Number=Sing
dahulu	dahulu	NOUN	Number=Sing
Phoenician	Phoenician	PROPN	_
ekstensif	ekstensif	ADJ	_
menjajah	jajah	VERB	Mood=Ind|Voice=Act
Augustus	Augustus	PROPN	_
Kekaisaran	Kekaisaran	PROPN	_
Mare	Mare	PROPN	_
Nostrum	Nostrum	PROPN	_
Blindleia	Blindleia	PROPN	_
jalan	jalan	NOUN	Number=Sing
karang	karang	NOUN	Number=Sing
terlindungi	lindung	VERB	Mood=Ind|Voice=Pass
terbentang	bentang	VERB	Mood=Ind|Voice=Pass
Kristiansand	Kristiansand	PROPN	_
melewati	lewat	VERB	Mood=Ind|Voice=Act
Lillesand	Lillesand	PROPN	_
laguna	laguna	NOUN	Number=Sing
dangkal	dangkal	ADJ	_
fjords	fjords	NOUN	Number=Sing
danau	danau	NOUN	Number=Sing
tawar	tawar	NOUN	Number=Sing
Minuman	minum	NOUN	Number=Sing
beralkohol	alkohol	VERB	Mood=Ind|Voice=Act
bir	bir	NOUN	Number=Sing
mead	mead	NOUN	Number=Sing
bjórr	bjórr	NOUN	Number=Sing
anggur	anggur	NOUN	Number=Sing
buah	buah	NOUN	Number=Sing
disajikan	saji	VERB	Mood=Ind|Voice=Pass
pertarungan	tarung	NOUN	Number=Sing
berakhir	akhir	VERB	Mood=Ind|Voice=Act
kematian	mati	NOUN	Number=Sing
kuda	kuda	NOUN	Number=Sing
jantan	jantan	NOUN	Number=Sing
Schlei	Schlei	PROPN	_
lahan	lahan	NOUN	Number=Sing
basah	basah	NOUN	Number=Sing
Danevirke	Danevirke	PROPN	_
Husum	Husum	PROPN	_
beku	beku	ADJ	_
ditaklukkan	takluk	VERB	Mood=Ind|Voice=Pass
bala	bala	NOUN	Number=Sing
Kemunduran	mundur	NOUN	Number=Sing
Austro-Prussia	Austro-Prussia	PROPN	_
evakuasi	evakuasi	NOUN	Number=Sing
ditinggalkan	tinggal	VERB	Mood=Ind|Voice=Pass
barang-barang	barang	NOUN	Number=Plur
artileri	artileri	NOUN	Number=Sing
berat	berat	ADJ	_
historis	historis	ADJ	_
rel	rel	NOUN	Number=Sing
Flensburg	Flensburg	PROPN	_
semestinya	mesti	ADV	_
menganggap	anggap	VERB	Mood=Ind|Voice=Act
terkalahkan	kalah	VERB	Mood=Ind|Voice=Pass
Jenderal	Jenderal	PROPN	_
Jenderal	jenderal	NOUN	Number=Sing
de	de	PROPN	_
de	de	X	Foreign=Yes
Meza	Meza	PROPN	_
dibebastugaskan	bebas-tugas	VERB	Mood=Ind|Voice=Pass
komando	komando	NOUN	Number=Sing
Sejak	sejak	ADP	_
milik	milik	NOUN	Number=Sing
Jumlah	jumlah	NOUN	Number=Sing
diangkut	angkut	VERB	Mood=Ind|Voice=Pass
Danube	Danube	PROPN	_
ton	ton	NOUN	Number=Sing
1987	1987	NUM	NumType=Card
Delta	Delta	PROPN	_
Rumania	Rumania	PROPN	_
Tulcea	Tulcea	PROPN	_
sebelah	belah	NOUN	Number=Sing
kiri	kiri	NOUN	Number=Sing
tepi	tepi	NOUN	Number=Sing
Chilia	Chilia	PROPN	_
Arm	Arm	PROPN	_
Ukraina	Ukraina	PROPN	_
Odessa	Odessa	PROPN	_
Oblast	Oblast	PROPN	_
kering	kering	ADJ	_
sampai-sampai	sampai	SCONJ	_
dataran	datar	NOUN	Number=Sing
kadang	kadang	ADV	PronType=Ind
disangka	sangka	VERB	Mood=Ind|Voice=Pass
Berbeda	beda	VERB	Mood=Ind|Voice=Act
topografi	topografi	NOUN	Number=Sing
menonjol	tonjol	VERB	Mood=Ind|Voice=Act
Aljazair	Aljazair	PROPN	_
zona	zona	NOUN	Number=Sing
terutama	utama	ADJ	Degree=Sup
Ohio	Ohio	PROPN	_
mengalir	alir	VERB	Mood=Ind|Voice=Act
Mississippi	Mississippi	PROPN	_
jantung	jantung	NOUN	Number=Sing
Kansas	Kansas	PROPN	_
bebas	bebas	ADJ	_
budak	budak	NOUN	Number=Sing
Reaksi	reaksi	NOUN	Number=Sing
peristiwa	peristiwa	NOUN	Number=Sing
terpecah	pecah	VERB	Mood=Ind|Voice=Pass
dedaunan	daun	NOUN	Number=Plur
ragam	ragam	NOUN	Number=Sing
hijau	hijau	ADJ	_
kekuningan	kuning	ADJ	_
kebiruan	biru	ADJ	_
Penduduk	duduk	NOUN	Number=Sing
pokok	pokok	NOUN	Number=Sing
perawatan	rawat	NOUN	Number=Sing
Gereja-gereja	gereja	NOUN	Number=Plur
Kristen	Kristen	PROPN	_
cabang	cabang	NOUN	Number=Sing
pohon	pohon	NOUN	Number=Sing
Gandarusa	gandarusa	NOUN	Number=Sing
pengganti	ganti	NOUN	Number=Sing
palem	palem	NOUN	Number=Sing
Palem	Palem	PROPN	_
Pegunungan	gunung	NOUN	Number=Sing
Alpen	Alpen	PROPN	_
irigasi	irigasi	NOUN	Number=Sing
90	90	NUM	NumType=Card
bulan-bulan	bulan	NOUN	Number=Plur
panas	panas	ADJ	_
Kota-kota	kota	NOUN	Number=Plur
Milan	Milan	PROPN	_
80	80	NUM	NumType=Card
aliran	alir	NOUN	Number=Sing
Air	air	NOUN	Number=Sing
sungai	sungai	NOUN	Number=Sing
500	500	NUM	NumType=Card
sebanyak	banyak	NOUN	Number=Sing
2900	2900	NUM	NumType=Card
kilowatt	kilowatt	NOUN	Number=Sing
Sungai-sungai	sungai	NOUN	Number=Plur
Swiss	Swiss	PROPN	_
Rhine	Rhine	PROPN	_
Rhône	Rhône	PROPN	_
Inn	Inn	PROPN	_
Ticino	Ticino	PROPN	_
Po	Po	PROPN	_
berhulu	hulu	VERB	Mood=Ind|Voice=Act
tetangga	tetangga	NOUN	Number=Sing
Mediterranean	Mediterranean	PROPN	_
Atlantik	Atlantik	PROPN	_
Hitam	Hitam	PROPN	_
berapi	api	VERB	Mood=Ind|Voice=Act
volkanologi	volkanologi	NOUN	Number=Sing
kadang-kadang	kadang	ADV	PronType=Ind
dieja	eja	VERB	Mood=Ind|Voice=Pass
vulkanologi	vulkanologi	NOUN	Number=Sing
Magma	magma	NOUN	Number=Sing
kental	kental	ADJ	_
silika	silika	NOUN	Number=Sing
melainkan	lain	CCONJ	_
mendingin	dingin	VERB	Mood=Ind|Voice=Act
kedalaman	dalam	NOUN	Number=Sing
Biasanya	biasa	ADV	_
meletus	letus	VERB	Mood=Ind|Voice=Act
bencana	bencana	NOUN	Number=Sing
Pemanasan	panas	NOUN	Number=Sing
Mengandung	kandung	VERB	Mood=Ind|Voice=Act
Dinyatakan	nyata	VERB	Mood=Ind|Voice=Pass
cagar	cagar	NOUN	Number=Sing
1975	1975	NUM	NumType=Card
ekspedisi	ekspedisi	NOUN	Number=Sing
Pemukiman	mukim	NOUN	Number=Sing
1000	1000	NUM	NumType=Card
Melanesia	Melanesia	PROPN	_
timur	timur	NOUN	Number=Sing
berkelana	kelana	VERB	Mood=Ind|Voice=Act
tahun-tahun	tahun	NOUN	Number=Plur
Kentucky	Kentucky	PROPN	_
Indiana	Indiana	PROPN	_
Thomas	Thomas	PROPN	_
petani	tani	NOUN	Number=Sing
lemari	lemari	NOUN	Number=Sing
tukang	tukang	NOUN	Number=Sing
kayu	kayu	NOUN	Number=Sing
Kehancuran	hancur	NOUN	Number=Sing
habitat	habitat	NOUN	Number=Sing
tajam	tajam	ADJ	_
area-area	area	NOUN	Number=Plur
rentan	rentan	ADJ	_
kekeringan	kering	NOUN	Number=Sing
gagal	gagal	VERB	Mood=Ind|Voice=Act
panen	panen	NOUN	Number=Sing
penyebaran	sebar	NOUN	Number=Sing
penyakit	sakit	NOUN	Number=Sing
kontaminasi	kontaminasi	NOUN	Number=Sing
ekosistem	ekosistem	NOUN	Number=Sing
praktik	praktik	NOUN	Number=Sing
manajemen	manajemen	NOUN	Number=Sing
merugikan	rugi	VERB	Mood=Ind|Voice=Act
Lahan	lahan	NOUN	Number=Sing
pertanian	tani	NOUN	Number=Sing
kehancuran	hancur	NOUN	Number=Sing
menurun	turun	VERB	Mood=Ind|Voice=Act
40	40	NUM	NumType=Card
erosi	erosi	NOUN	Number=Sing
salinisasi	salinisasi	NOUN	Number=Sing
pemadatan	padat	NOUN	Number=Sing
kehabisan	habis	VERB	Mood=Ind|Voice=Pass
polusi	polusi	NOUN	Number=Sing
urbanisasi	urbanisasi	NOUN	Number=Sing
Manusia	manusia	NOUN	Number=Sing
alami	alami	ADJ	_
hancur	hancur	VERB	Mood=Ind|Voice=Act
Papua	Papua	PROPN	_
Nugini	Nugini	PROPN	_
dijuluki	juluk	VERB	Mood=Ind|Voice=Pass
terburuk	buruk	ADJ	Degree=Sup
kekerasan	keras	NOUN	Number=Sing
gender	gender	NOUN	Number=Sing
Keluarga	keluarga	NOUN	Number=Sing
diperlakukan	laku	VERB	Mood=Ind|Voice=Pass
benua	benua	NOUN	Number=Sing
mode	mode	NOUN	Number=Sing
tujuh	tujuh	NUM	NumType=Card
Christopher	Christopher	PROPN	_
Columbus	Columbus	PROPN	_
berlayar	layar	VERB	Mood=Ind|Voice=Act
Barat	Barat	PROPN	_
Barat	barat	NOUN	Number=Sing
1492	1492	NUM	NumType=Card
menyulut	sulut	VERB	Mood=Ind|Voice=Act
ekplorasi	ekplorasi	NOUN	Number=Sing
pedalaman	dalam	NOUN	Number=Sing
pribadi	pribadi	NOUN	Number=Sing
tersisa	sisa	VERB	Mood=Ind|Voice=Pass
Alaska	Alaska	PROPN	_
siang	siang	NOUN	Number=Sing
Beragam	ragam	ADJ	_
mendiami	diam	VERB	Mood=Ind|Voice=Act
ribuan	ribu	NUM	NumType=Card
mencuri	curi	VERB	Mood=Ind|Voice=Act
kano	kano	NOUN	Number=Sing
Aborigin	Aborigin	PROPN	_
memburuk	buruk	VERB	Mood=Ind|Voice=Act
selokan	selokan	NOUN	Number=Sing
terbuka	buka	VERB	Mood=Ind|Voice=Pass
diproklamirkan	proklamasi	VERB	Mood=Ind|Voice=Pass
Sallyanne	Sallyanne	PROPN	_
Atkinson	Atkinson	PROPN	_
Badai	badai	NOUN	Number=Sing
debu	debu	NOUN	Number=Sing
dilindungi	lindung	VERB	Mood=Ind|Voice=Pass
vegetasi	vegetasi	NOUN	Number=Sing
menutupi	tutup	VERB	Mood=Ind|Voice=Act
gurun	gurun	NOUN	Number=Sing
materi-materi	materi	NOUN	Number=Plur
halus	halus	ADJ	_
terhembus	hembus	VERB	Mood=Ind|Voice=Pass
berhembus	embus	VERB	Mood=Ind|Voice=Act
partikel-partikel	partikel	NOUN	Number=Plur
kecepatan	cepat	NOUN	Number=Sing
partikel	partikel	NOUN	Number=Sing
terangkat	angkat	VERB	Mood=Ind|Voice=Pass
mendarat	darat	VERB	Mood=Ind|Voice=Act
bertabrakan	tabrak	VERB	Mood=Ind|Voice=Act
tersentak	sentak	VERB	Mood=Ind|Voice=Pass
giliran	gilir	NOUN	Number=Sing
reaksi	reaksi	NOUN	Number=Sing
berantai	rantai	VERB	Mood=Ind|Voice=Act
Thailand	Thailand	PROPN	_
masalah-masalah	masalah	NOUN	Number=Plur
obesitas	obesitas	NOUN	Number=Sing
Hujan	hujan	NOUN	Number=Sing
badai	badai	NOUN	Number=Sing
1340	1340	NUM	NumType=Card
Kairo	Kairo	PROPN	_
populasi	populasi	NOUN	Number=Sing
mendekati	dekat	VERB	Mood=Ind|Voice=Act
setengah	tengah	NUM	NumType=Card
menjadikan	jadi	VERB	Mood=Ind|Voice=Act
tambahan	tambah	NOUN	Number=Sing
memupuk	pupuk	VERB	Mood=Ind|Voice=Act
Pulau	Pulau	PROPN	_
Pulau	pulau	NOUN	Number=Sing
Gezira	Gezira	PROPN	_
perairan	air	NOUN	Number=Sing
Output	output	NOUN	Number=Sing
Nevada	Nevada	PROPN	_
turisme	turisme	NOUN	Number=Sing
pertambangan	tambang	NOUN	Number=Sing
permesinan	mesin	NOUN	Number=Sing
percetakan	cetak	NOUN	Number=Sing
pemrosesan	proses	NOUN	Number=Sing
peralatan	alat	NOUN	Number=Sing
Nama	nama	NOUN	Number=Sing
Karibia	Karibia	PROPN	_
Carib	Carib	PROPN	_
Suku	suku	NOUN	Number=Sing
Asli	asli	ADJ	_
ke-15	15	ADJ	NumType=Ord
penemuan	temu	NOUN	Number=Sing
istilah	istilah	NOUN	Number=Sing
Spanyol	Spanyol	PROPN	_
Antillas	Antillas	PROPN	_
diberlakukan	laku	VERB	Mood=Ind|Voice=Pass
Antilles	Antilles	PROPN	_
pengembangan	kembang	NOUN	Number=Sing
terbantahkan	bantah	VERB	Mood=Ind|Voice=Pass
Mulai	mulai	ADP	_
ke-16	16	ADJ	NumType=Ord
Panama	Panama	PROPN	_
diketahui	tahu	VERB	Mood=Ind|Voice=Pass
diketahui	ketahui	VERB	Mood=Ind|Voice=Pass
Eurasia	Eurasia	PROPN	_
Asia	Asia	PROPN	_
ekspansi	ekspansi	NOUN	Number=Sing
perkotaan	kota	NOUN	Number=Sing
Cape	Cape	PROPN	_
Town	Town	PROPN	_
Esai	esai	NOUN	Number=Sing
diterbitkan	terbit	VERB	Mood=Ind|Voice=Pass
Undersea	Undersea	PROPN	_
narasi	narasi	NOUN	Number=Sing
samudra	samudra	NOUN	Number=Sing
memanfaatkan	manfaat	VERB	Mood=Ind|Voice=Act
memasok	pasok	VERB	Mood=Ind|Voice=Act
rahasia	rahasia	ADJ	_
1962	1962	NUM	NumType=Card
Brooks	Brooks	PROPN	_
penyuntingan	sunting	NOUN	Number=Sing
meletakkan	letak	VERB	Mood=Ind|Voice=Act
mempromosikan	promosi	VERB	Mood=Ind|Voice=Act
mengirimkan	kirim	VERB	Mood=Ind|Voice=Act
manuskrip	manuskrip	NOUN	Number=Sing
terpilih	pilih	VERB	Mood=Ind|Voice=Pass
saran	saran	NOUN	Number=Sing
memunculkan	muncul	VERB	Mood=Ind|Voice=Act
perhatian	hati	NOUN	Number=Sing
demikian	demikian	PRON	PronType=Dem
rakyat	rakyat	NOUN	Number=Sing
1350-an	1350	NUM	NumType=Card
Gongmin	Gongmin	PROPN	_
mereformasi	reformasi	VERB	Mood=Ind|Voice=Act
Goryeo	Goryeo	PROPN	_
dinasti	dinasti	NOUN	Number=Sing
Yuan	Yuan	PROPN	_
runtuh	runtuh	VERB	Mood=Ind|Voice=Act
1960-an	1960	NUM	NumType=Card
perekonomian	ekonomi	NOUN	Number=Sing
pesat	pesat	ADJ	_
struktur	struktur	NOUN	Number=Sing
ditransformasi	transformasi	VERB	Mood=Ind|Voice=Pass
piknik	piknik	VERB	Mood=Ind|Voice=Act
pedesaan	desa	NOUN	Number=Sing
kursi-kursi	kursi	NOUN	Number=Plur
pejalan	jalan	NOUN	Number=Sing
Royal	Royal	PROPN	_
Park	Park	PROPN	_
1879	1879	NUM	NumType=Card
taman	taman	NOUN	Number=Sing
penyediaan	sedia	NOUN	Number=Sing
dimanfaatkan	manfaat	VERB	Mood=Ind|Voice=Pass
setempat	tempat	NOUN	Number=Sing
Dinasti	Dinasti	PROPN	_
Qing	Qing	PROPN	_
1911	1911	NUM	NumType=Card
Mongolia	Mongolia	PROPN	_
Bogd	Bogd	PROPN	_
Khaan	Khaan	PROPN	_
mendeklarasikan	deklarasi	VERB	Mood=Ind|Voice=Act
Shikai	Shikai	PROPN	_
penerus	terus	NOUN	Number=Sing
maupun	maupun	CCONJ	_
diperintah	perintah	VERB	Mood=Ind|Voice=Pass
Manchu	Manchu	PROPN	_
kontrak	kontrak	NOUN	Number=Sing
ketundukan	tunduk	NOUN	Number=Sing
Daerah	daerah	NOUN	Number=Sing
dikontrol	kontrol	VERB	Mood=Ind|Voice=Pass
Outer	Outer	PROPN	_
Tergesa-gesa	gesa	ADV	_
Kadesh	Kadesh	PROPN	_
Ramesses	Ramesses	PROPN	_
II	ii	ADJ	NumType=Ord
kesalahan	salah	NOUN	Number=Sing
taktik	taktik	NOUN	Number=Sing
Laporan	lapor	NOUN	Number=Sing
pertempuran	tempur	NOUN	Number=Sing
James	James	PROPN	_
Henry	Henry	PROPN	_
Breasted	Breasted	PROPN	_
1903	1903	NUM	NumType=Card
memuji	puji	VERB	Mood=Ind|Voice=Act
sumber-sumber	sumber	NOUN	Number=Plur
rekonstruksi	rekonstruksi	NOUN	Number=Sing
kepastian	pasti	NOUN	Number=Sing
logistik	logistik	ADJ	_
logistik	logistik	NOUN	Number=Sing
pengepungan	kepung	NOUN	Number=Sing
Mesir	Mesir	PROPN	_
Demikian	demikian	PRON	PronType=Dem
firaun	firaun	NOUN	Number=Sing
Amurru	Amurru	PROPN	_
lewat	lewat	VERB	Mood=Ind|Voice=Act
Tunip	Tunip	PROPN	_
Thutmose	Thutmose	PROPN	_
120	120	NUM	NumType=Card
Kali	kali	NOUN	Number=Sing
mengklaim	klaim	VERB	Mood=Ind|Voice=Act
bertempur	tempur	VERB	Mood=Ind|Voice=Act
repot-repot	repot	ADV	_
baju	baju	NOUN	Number=Sing
zirah	zirah	NOUN	Number=Sing
jam	jam	NOUN	Number=Sing
pernikahan	nikah	NOUN	Number=Sing
Herodes	Herodes	PROPN	_
Antipas	Antipas	PROPN	_
Herodias	Herodias	PROPN	_
diperdebatkan	debat	VERB	Mood=Ind|Voice=Pass
Mengingat	ingat	VERB	Mood=Ind|Voice=Act
Yerusalem	Yerusalem	PROPN	_
Pilatus	Pilatus	PROPN	_
Yesus	Yesus	PROPN	_
diadili	adil	VERB	Mood=Ind|Voice=Pass
Baru	Baru	PROPN	_
Baru	baru	ADJ	_
Paulus	Paulus	PROPN	_
belas	belas	NUM	NumType=Card
belas	belas	NUM	_
Korintus	Korintus	PROPN	_
pertobatan	tobat	NOUN	Number=Sing
Tanggal	tanggal	NOUN	Number=Sing
jatuh	jatuh	VERB	Mood=Ind|Voice=Act
Jumat	Jumat	PROPN	_
kabisat	kabisat	NOUN	Number=Sing
pengecualian	kecuali	NOUN	Number=Sing
didukung	dukung	VERB	Mood=Ind|Voice=Pass
Newton	Newton	PROPN	_
fase	fase	NOUN	Number=Sing
ribu	ribu	NUM	NumType=Card
dihalangi	halang	VERB	Mood=Ind|Voice=Pass
Benteng-benteng	benteng	NOUN	Number=Plur
France	France	PROPN	_
integrasi	integrasi	NOUN	Number=Sing
mekanisme	mekanisme	NOUN	Number=Sing
yudisial	yudisial	ADJ	_
diterapkan	terap	VERB	Mood=Ind|Voice=Pass
Latium	Latium	PROPN	_
Italia	Italia	PROPN	_
puisi	puisi	NOUN	Number=Sing
menarasikan	narasi	VERB	Mood=Ind|Voice=Act
masa-masa	masa	NOUN	Number=Plur
sejarawan	sejarawan	NOUN	Number=Sing
intelektual	intelektual	NOUN	Number=Sing
intelektual	intelektual	ADV	_
karya-karya	karya	NOUN	Number=Plur
diilhami	ilham	VERB	Mood=Ind|Voice=Pass
Perang	perang	NOUN	Number=Sing
Perang	Perang	PROPN	_
Troya	Troya	PROPN	_
Diramalkan	ramal	VERB	Mood=Ind|Voice=Pass
monoton	monoton	ADJ	_
muda	muda	ADJ	_
medan	medan	NOUN	Number=Sing
keabadian	abadi	NOUN	Number=Sing
dimundurkan	mundur	VERB	Mood=Ind|Voice=Pass
Julian	Julian	PROPN	_
363	363	NUM	NumType=Card
diyakini	yakin	VERB	Mood=Ind|Voice=Pass
diadakan	ada	VERB	Mood=Ind|Voice=Pass
393	393	NUM	NumType=Card
Shen	Shen	PROPN	_
Kuo	Kuo	PROPN	_
Wang	Wang	PROPN	_
Anshi	Anshi	PROPN	_
kagum	kagum	ADJ	_
administrator	administrator	NOUN	Number=Sing
1072	1072	NUM	NumType=Card
program	program	NOUN	Number=Sing
menyurvei	survei	VERB	Mood=Ind|Voice=Act
lumpur	lumpur	NOUN	Number=Sing
Kanal	Kanal	PROPN	_
Bian	Bian	PROPN	_
Menggunakan	guna	VERB	Mood=Ind|Voice=Act
teknik	teknik	NOUN	Number=Sing
mengeruk	keruk	VERB	Mood=Ind|Voice=Act
kanal	kanal	NOUN	Number=Sing
dahsyat	dahsyat	ADJ	_
dikumpulkan	kumpul	VERB	Mood=Ind|Voice=Pass
pupuk	pupuk	NOUN	Number=Sing
memperoleh	oleh	VERB	Mood=Ind|Voice=Act
istana	istana	NOUN	Number=Sing
utusan	utus	NOUN	Number=Sing
Khitan	Khitan	PROPN	_
Liao	Liao	PROPN	_
1075	1075	NUM	NumType=Card
negosiasi	negosiasi	NOUN	Number=Sing
agresif	agresif	ADJ	_
sambil	sambil	SCONJ	_
memanipulasi	manipulasi	VERB	Mood=Ind|Voice=Act
kompeten	kompeten	ADJ	_
menyerah	serah	VERB	Mood=Ind|Voice=Act
Kerajaan	Kerajaan	PROPN	_
Kerajaan	raja	NOUN	Number=Sing
Kedokteran	dokter	NOUN	Number=Sing
dipelajari	ajar	VERB	Mood=Ind|Voice=Pass
kedokteran	dokter	NOUN	Number=Sing
Salerno	Salerno	PROPN	_
Tiberius	Tiberius	PROPN	_
menyesali	sesal	VERB	Mood=Ind|Voice=Act
keberangkatan	berangkat	NOUN	Number=Sing
bertindak	tindak	VERB	Mood=Ind|Voice=Act
perintah	perintah	NOUN	Number=Sing
agak	agak	ADV	_
perdebatan	debat	NOUN	Number=Sing
sebenarnya	benar	ADV	_
Dewa-dewa	dewa	NOUN	Number=Plur
kebutuhan	butuh	NOUN	Number=Sing
praktis	praktis	ADJ	_
ritual	ritual	NOUN	Number=Sing
persembahan	sembah	NOUN	Number=Sing
pantas	pantas	ADJ	_
Sisa-sisa	sisa	NOUN	Number=Plur
peribadatan	ibadat	NOUN	Number=Sing
jajaran	jajar	NOUN	Number=Sing
batu-batu	batu	NOUN	Number=Plur
berdiri	diri	VERB	Mood=Ind|Voice=Act
massebot	massebot	X	_
berorientasi	orientasi	VERB	Mood=Ind|Voice=Act
altar	altar	NOUN	Number=Sing
tengah	tengah	NOUN	Number=Sing
bak	bak	NOUN	Number=Sing
berbentuk	bentuk	VERB	Mood=Ind|Voice=Act
persegi	segi	NOUN	Number=Sing
Kanaan	Kanaan	PROPN	_
Zaman	Zaman	PROPN	_
Perunggu	Perunggu	PROPN	_
Pertengahan	Pertengahan	PROPN	_
Pertengahan	tengah	NOUN	Number=Sing
1600	1600	NUM	NumType=Card
hangus	hangus	VERB	Mood=Ind|Voice=Act
sesudah	sudah	ADP	_
Rujukan	rujuk	NOUN	Number=Sing
tertua	tua	ADJ	Degree=Sup
prasasti	prasasti	NOUN	Number=Sing
tempat-tempat	tempat	NOUN	Number=Plur
kuil	kuil	NOUN	Number=Sing
Karnak	Karnak	PROPN	_
Surat-surat	surat	NOUN	Number=Plur
Tell	Tell	PROPN	_
Amarna	Amarna	PROPN	_
ke-14	14	ADJ	NumType=Ord
sepuluh	puluh	NUM	NumType=Card
Gezer	Gezer	PROPN	_
setia	setia	ADJ	_
Akta	akta	NOUN	Number=Sing
mencatat	catat	VERB	Mood=Ind|Voice=Act
kalender	kalender	NOUN	Number=Sing
Cina	Cina	PROPN	_
hewan	hewan	NOUN	Number=Sing
zodiak	zodiak	NOUN	Number=Sing
Hewan	hewan	NOUN	Number=Sing
Monyet	monyet	NOUN	Number=Sing
keenampuluh	enam	ADJ	NumType=Ord
1992	1992	NUM	NumType=Card
Warna	warna	NOUN	Number=Sing
ditunjukkan	tunjuk	VERB	Mood=Ind|Voice=Pass
tabel	tabel	NOUN	Number=Sing
hari-hari	hari	NOUN	Number=Plur
seminggu	minggu	NOUN	Number=Sing
Budha	Budha	PROPN	_
dianut	anut	VERB	Mood=Ind|Voice=Pass
bervariasi	variasi	VERB	Mood=Ind|Voice=Act
kebudayaan	budaya	NOUN	Number=Sing
perayaan-perayaan	raya	NOUN	Number=Plur
dihitung	hitung	VERB	Mood=Ind|Voice=Pass
memperkuat	kuat	VERB	Mood=Ind|Voice=Act
Tembok	Tembok	PROPN	_
Penguasa	Penguasa	PROPN	_
ditandai	tanda	VERB	Mood=Ind|Voice=Pass
konstruksi	konstruksi	NOUN	Number=Sing
berdua	dua	NUM	NumType=Card
berdua	dua	NUM	_
kelihatannya	lihat	ADV	_
memegang	pegang	VERB	Mood=Ind|Voice=Act
2002	2002	NUM	NumType=Card
Aldrin	Aldrin	PROPN	_
dibujuk	bujuk	VERB	Mood=Ind|Voice=Pass
hotel	hotel	NOUN	Number=Sing
Beverly	Beverly	PROPN	_
Hills	Hills	PROPN	_
dalih	dalih	NOUN	Number=Sing
diwawancarai	wawancara	VERB	Mood=Ind|Voice=Pass
televisi	televisi	NOUN	Number=Sing
menikah	nikah	VERB	Mood=Ind|Voice=Act
1519	1519	NUM	NumType=Card
penguasa	kuasa	NOUN	Number=Sing
kekaisaran	kaisar	NOUN	Number=Sing
Habsburg	Habsburg	PROPN	_
Kaisar	kaisar	NOUN	Number=Sing
Kaisar	Kaisar	PROPN	_
Suci	suci	ADJ	_
Romawi	Romawi	PROPN	_
1530	1530	NUM	NumType=Card
Charles	Charles	PROPN	_
dipandang	pandang	VERB	Mood=Ind|Voice=Pass
1566	1566	NUM	NumType=Card
liga	liga	NOUN	Number=Sing
400	400	NUM	NumType=Card
bangsawan	bangsawan	NOUN	Number=Sing
gubernur	gubernur	NOUN	Number=Sing
Parma	Parma	PROPN	_
menangguhkan	tangguh	VERB	Mood=Ind|Voice=Act
Perjuangan	juang	NOUN	Number=Sing
Ottoman	Ottoman	PROPN	_
pemberontak	berontak	NOUN	Number=Sing
Observatorium	observatorium	NOUN	Number=Sing
astronomi	astronomi	NOUN	Number=Sing
1900	1900	NUM	NumType=Card
melayani	layan	VERB	Mood=Ind|Voice=Act
700	700	NUM	NumType=Card
Ruang	ruang	NOUN	Number=Sing
mengamati	amat	VERB	Mood=Ind|Voice=Act
terbit	terbit	VERB	Mood=Ind|Voice=Act
matahari	matahari	NOUN	Number=Sing
purnama	purnama	NOUN	Number=Sing
Tiga	tiga	NUM	NumType=Card
penanda	tanda	NOUN	Number=Sing
ekuinoks	ekuinoks	NOUN	Number=Sing
deklinasi	deklinasi	NOUN	Number=Sing
mengukur	ukur	VERB	Mood=Ind|Voice=Act
Kepentingan	penting	NOUN	Number=Sing
Pasca-Klasik	Pasca-Klasik	PROPN	_
Yucatán	Yucatán	PROPN	_
Asal	asal	NOUN	Number=Sing
Hispania	Hispania	PROPN	_
spekulasi	spekulasi	NOUN	Number=Sing
didasarkan	dasar	VERB	Mood=Ind|Voice=Pass
kebetulan	betul	ADJ	_
pendatang	datang	NOUN	Number=Sing
tahap-tahap	tahap	NOUN	Number=Plur
Romanisasi	Romanisasi	PROPN	_
semenanjung	semenanjung	NOUN	Number=Sing
dibagi	bagi	VERB	Mood=Ind|Voice=Pass
tujuan	tuju	NOUN	Number=Sing
administratif	administratif	ADJ	_
ke-3	3	ADJ	NumType=Ord
Caracalla	Caracalla	PROPN	_
divisi	divisi	NOUN	Number=Sing
terpana	pana	VERB	Mood=Ind|Voice=Pass
keindahan	indah	NOUN	Number=Sing
Danau	Danau	PROPN	_
Rudyard	Rudyard	PROPN	_
menamai	nama	VERB	Mood=Ind|Voice=Act
Kipling	Kipling	PROPN	_
cinta	cinta	NOUN	Number=Sing
Florence	Florence	PROPN	_
Garrard	Garrard	PROPN	_
Trix	Trix	PROPN	_
Stephen	Stephen	PROPN	_
Wheeler	Wheeler	PROPN	_
editor	editor	NOUN	Number=Sing
terhentikan	henti	VERB	Mood=Ind|Voice=Pass
Lahore	Lahore	PROPN	_
puluh	puluh	NUM	NumType=Card
Surat	surat	NOUN	Number=Sing
Kabar	kabar	NOUN	Number=Sing
1886	1886	NUM	NumType=Card
June	June	PROPN	_
1887	1887	NUM	NumType=Card
Jin	Jin	PROPN	_
Ping	Ping	PROPN	_
Mei	Mei	PROPN	_
1610	1610	NUM	NumType=Card
menandai	tanda	VERB	Mood=Ind|Voice=Act
karangan	karang	NOUN	Number=Sing
independen	independen	ADJ	_
psikologi	psikologi	NOUN	Number=Sing
Peningkatan	tingkat	NOUN	Number=Sing
pendapatan	dapat	NOUN	Number=Sing
kapita	kapita	NOUN	Number=Sing
laju	laju	NOUN	Number=Sing
studi	studi	NOUN	Number=Sing
penurunan	turun	NOUN	Number=Sing
menafsirkan	tafsir	VERB	Mood=Ind|Voice=Act
angka	angka	NOUN	Number=Sing
hilang	hilang	VERB	Mood=Ind|Voice=Act
pemberontakan	berontak	NOUN	Number=Sing
pejuang	juang	NOUN	Number=Sing
lumayan	lumayan	ADJ	_
patut	patut	ADJ	_
makmur	makmur	ADJ	_
Pendapatan	dapat	NOUN	Number=Sing
dikemukakan	muka	VERB	Mood=Ind|Voice=Pass
keluhan	keluh	NOUN	Number=Sing
Jaminan	jamin	NOUN	Number=Sing
menjanjikan	janji	VERB	Mood=Ind|Voice=Act
ketegangan	tegang	NOUN	Number=Sing
antarmasyarakat	antarmasyarakat	ADJ	_
harmonis	harmonis	ADJ	_
Revolusi	revolusi	NOUN	Number=Sing
Arab	Arab	PROPN	_
berbalik	balik	VERB	Mood=Ind|Voice=Act
Tengah	Tengah	PROPN	_
mendominasi	dominasi	VERB	Mood=Ind|Voice=Act
membahas	bahas	VERB	Mood=Ind|Voice=Act
kemanusiaan	manusia	NOUN	Number=Sing
Pastor	Pastor	PROPN	_
Heinrich	Heinrich	PROPN	_
Kramer	Kramer	PROPN	_
Dominika	Dominika	PROPN	_
Uskup	Uskup	PROPN	_
Salzburg	Salzburg	PROPN	_
1538	1538	NUM	NumType=Card
mempercayai	percaya	VERB	Mood=Ind|Voice=Act
Malleus	Malleus	PROPN	_
Baptisan	baptis	NOUN	Number=Sing
bertentangan	tentang	VERB	Mood=Ind|Voice=Act
Gereja	Gereja	PROPN	_
Katolik	Katolik	PROPN	_
dibaptis	baptis	VERB	Mood=Ind|Voice=Pass
Yudaisme	Yudaisme	PROPN	_
mengusir	usir	VERB	Mood=Ind|Voice=Act
Sephardic	Sephardic	PROPN	_
Yahudi	Yahudi	PROPN	_
Portugal	Portugal	PROPN	_
sasaran	sasar	NOUN	Number=Sing
Batas	batas	NOUN	Number=Sing
Thace	Thace	PROPN	_
Nestus	Nestus	PROPN	_
Mesta	Mesta	PROPN	_
Philip	Philip	PROPN	_
musuh-musuh	musuh	NOUN	Number=Plur
Thessaly	Thessaly	PROPN	_
musuh	musuh	NOUN	Number=Sing
352	352	NUM	NumType=Card
Tentara	tentara	NOUN	Number=Sing
Thermopylae	Thermopylae	PROPN	_
membagi	bagi	VERB	Mood=Ind|Voice=Act
dijaga	jaga	VERB	Mood=Ind|Voice=Pass
gabungan	gabung	NOUN	Number=Sing
Sparta	Sparta	PROPN	_
Achaean	Achaean	PROPN	_
Macedon	Macedon	PROPN	_
menghimpun	himpun	VERB	Mood=Ind|Voice=Act
pasukan	pasukan	NOUN	Number=Sing
Catherine	Catherine	PROPN	_
puas	puas	ADJ	_
Pearl	Pearl	PROPN	_
Harbor	Harbor	PROPN	_
propaganda	propaganda	NOUN	Number=Sing
Visi	visi	NOUN	Number=Sing
ideal	ideal	ADJ	_
monarki	monarki	NOUN	Number=Sing
Romanov	Romanov	PROPN	_
membutakan	buta	VERB	Mood=Ind|Voice=Act
pengelompokan	kelompok	NOUN	Number=Sing
etnis	etnis	NOUN	Number=Sing
tanda-tanda	tanda	NOUN	Number=Plur
perpecahan	pecah	NOUN	Number=Sing
Sukhothai	Sukhothai	PROPN	_
Kontak	kontak	NOUN	Number=Sing
menguntungkan	untung	VERB	Mood=Ind|Voice=Act
berprestasi	prestasi	VERB	Mood=Ind|Voice=Act
Kuba	Kuba	PROPN	_
pos-pos	pos	NOUN	Number=Plur
persiapan	siap	NOUN	Number=Sing
Mengandalkan	andal	VERB	Mood=Ind|Voice=Act
milisi	milisi	NOUN	Number=Sing
latihan	latih	NOUN	Number=Sing
unjuk	unjuk	NOUN	Number=Sing
pendudukan	duduk	NOUN	Number=Sing
perjanjian	janji	NOUN	Number=Sing
perdamaian	damai	NOUN	Number=Sing
Puerto	Puerto	PROPN	_
Rico	Rico	PROPN	_
Guam	Guam	PROPN	_
Filipina	Filipina	PROPN	_
Serangan	serang	NOUN	Number=Sing
diperoleh	oleh	VERB	Mood=Ind|Voice=Pass
Venesia	Venesia	PROPN	_
diluncurkan	luncur	VERB	Mood=Ind|Voice=Pass
1563	1563	NUM	NumType=Card
merosot	perosot	VERB	Mood=Ind|Voice=Act
168.000	168.000	NUM	NumType=Card
Pendidikan	didik	NOUN	Number=Sing
Renaissance	Renaissance	PROPN	_
literatur	literatur	NOUN	Number=Sing
klasik	klasik	ADJ	_
moral	moral	NOUN	Number=Sing
pemahaman	paham	NOUN	Number=Sing
intensif	intensif	ADJ	_
analisis	analisis	NOUN	Number=Sing
statistik	statistik	NOUN	Number=Sing
demografi	demografi	NOUN	Number=Sing
menyertakan	serta	VERB	Mood=Ind|Voice=Act
melahirkan	lahir	VERB	Mood=Ind|Voice=Act
pemakaman	makam	NOUN	Number=Sing
benda-benda	benda	NOUN	Number=Plur
kuburan	kubur	NOUN	Number=Sing
penggembalaan	gembala	NOUN	Number=Sing
ternak	ternak	NOUN	Number=Sing
Sisilia	Sisilia	PROPN	_
Pithekoussae	Pithekoussae	PROPN	_
Cumae	Cumae	PROPN	_
alfabet	alfabet	NOUN	Number=Sing
meluas	luas	VERB	Mood=Ind|Voice=Act
Pisang	pisang	NOUN	Number=Sing
pisang	pisang	NOUN	Number=Sing
dibudidayakan	budidaya	VERB	Mood=Ind|Voice=Pass
Tenggara	Tenggara	PROPN	_
lokal	lokal	ADJ	_
5000	5000	NUM	NumType=Card
wol	wol	NOUN	Number=Sing
Perubahan	ubah	NOUN	Number=Sing
fundamental	fundamental	ADJ	_
prinsip-prinsip	prinsip	NOUN	Number=Plur
dibawa	bawa	VERB	Mood=Ind|Voice=Pass
bernama	nama	VERB	Mood=Ind|Voice=Act
Watt	Watt	PROPN	_
Industri	industri	NOUN	Number=Sing
cadang	cadang	NOUN	Number=Sing
logam	logam	NOUN	Number=Sing
mesin	mesin	NOUN	Number=Sing
Messenia	Messenia	PROPN	_
Kedua	dua	ADJ	NumType=Ord
Kedua	dua	NUM	NumType=Card
mengukuhkan	kukuh	VERB	Mood=Ind|Voice=Act
Peloponnesus	Peloponnesus	PROPN	_
Ford	Ford	PROPN	_
T	T	PROPN	_
ke-20	20	ADJ	NumType=Ord
ajang	ajang	NOUN	Number=Sing
Mobil	mobil	NOUN	Number=Sing
Abad	abad	NOUN	Number=Sing
Kesuksesan	sukses	NOUN	Number=Sing
Rambler	Rambler	PROPN	_
berukuran	ukur	VERB	Mood=Ind|Voice=Act
ringkas	ringkas	ADJ	_
Motors	Motors	PROPN	_
memacu	pacu	VERB	Mood=Ind|Voice=Act
GM	GM	PROPN	Abbr=Yes
ukuran	ukur	NOUN	Number=Sing
1960	1960	NUM	NumType=Card
Kebiasaan	biasa	NOUN	Number=Sing
longgar	longgar	ADJ	_
disarankan	saran	VERB	Mood=Ind|Voice=Pass
Meiji	Meiji	PROPN	_
kebiasaan	biasa	NOUN	Number=Sing
era	era	NOUN	Number=Sing
Sebelum	belum	ADP	_
Sebelum	belum	SCONJ	_
nama-nama	nama	NOUN	Number=Plur
diubah	ubah	VERB	Mood=Ind|Voice=Pass
wafat	wafat	VERB	Mood=Ind|Voice=Act
dipilih	pilih	VERB	Mood=Ind|Voice=Pass
Shōwa	Shōwa	PROPN	_
Pasific	Pasific	PROPN	_
Tionghoa	Tionghoa	PROPN	_
diperkirakan	kira	VERB	Mood=Ind|Voice=Pass
7,5	7,5	NUM	NumType=Card
Sekutu	sekutu	NOUN	Number=Sing
Peperangan	perang	NOUN	Number=Sing
lini	lini	NOUN	Number=Sing
statis	statis	ADJ	_
mobilitas	mobilitas	NOUN	Number=Sing
persenjataan	senjata	NOUN	Number=Sing
Anggota	anggota	NOUN	Number=Sing
kavaleri	kavaleri	NOUN	Number=Sing
pelatihan	latih	NOUN	Number=Sing
kepandaian	pandai	NOUN	Number=Sing
pedang	pedang	NOUN	Number=Sing
ulung	ulung	ADJ	_
Chandler	Chandler	PROPN	_
Weller	Weller	PROPN	_
dihancurkan	hancur	VERB	Mood=Ind|Voice=Pass
penyerangan	serang	NOUN	Number=Sing
epik	epik	ADJ	_
genetis	genetis	ADJ	_
autosomal	autosomal	ADJ	_
keturunan	turun	NOUN	Number=Sing
Penjelasan	jelas	NOUN	Number=Sing
usul	usul	NOUN	Number=Sing
musik	musik	NOUN	Number=Sing
didefinisikan	definisi	VERB	Mood=Ind|Voice=Pass
penyanyi	nyanyi	NOUN	Number=Sing
aktivitas	aktivitas	NOUN	Number=Sing
komunal	komunal	ADJ	_
1839	1839	NUM	NumType=Card
Opium	Opium	PROPN	_
Gubernur	gubernur	NOUN	Number=Sing
Hunan	Hunan	PROPN	_
Hubei	Hubei	PROPN	_
Lin	Lin	PROPN	_
Zexu	Zexu	PROPN	_
melarang	larang	VERB	Mood=Ind|Voice=Act
opium	opium	NOUN	Number=Sing
kalah	kalah	VERB	Mood=Ind|Voice=Act
1842	1842	NUM	NumType=Card
menyetujui	setuju	VERB	Mood=Ind|Voice=Act
Nanking	Nanking	PROPN	_
diserahkan	serah	VERB	Mood=Ind|Voice=Pass
pelabuhan	labuh	NOUN	Number=Sing
Shanghai	Shanghai	PROPN	_
Guangzhou	Guangzhou	PROPN	_
1856	1856	NUM	NumType=Card
terpaksa	paksa	VERB	Mood=Ind|Voice=Pass
Tientsin	Tientsin	PROPN	_
1858	1858	NUM	NumType=Card
Konvensi	Konvensi	PROPN	_
Peking	Peking	PROPN	_
1860	1860	NUM	NumType=Card
pelabuhan-pelabuhan	labuh	NOUN	Number=Plur
berdagang	dagang	VERB	Mood=Ind|Voice=Act
Lamarr	Lamarr	PROPN	_
mendampingi	damping	VERB	Mood=Ind|Voice=Act
Mandl	Mandl	PROPN	_
pertemuan-pertemuan	temu	NOUN	Number=Plur
berdiskusi	diskusi	VERB	Mood=Ind|Voice=Act
profesional	profesional	NOUN	Number=Sing
Penemuan	temu	NOUN	Number=Sing
terawal	awal	ADJ	Degree=Sup
lampu	lampu	NOUN	Number=Sing
lintas	lintas	NOUN	Number=Sing
tablet	tablet	NOUN	Number=Sing
larut	larut	ADJ	_
minuman	minum	NOUN	Number=Sing
berkarbonasi	karbonasi	VERB	Mood=Ind|Voice=Act
ditawari	tawar	VERB	Mood=Ind|Voice=Pass
naskah	naskah	NOUN	Number=Sing
pementasan	pentas	NOUN	Number=Sing
membangkitkan	bangkit	VERB	Mood=Ind|Voice=Act
minat	minat	NOUN	Number=Sing
Joseph	Joseph	PROPN	_
Darnand	Darnand	PROPN	_
perwira	perwira	NOUN	Number=Sing
SS	SS	PROPN	Abbr=Yes
Milice	Milice	PROPN	_
memburu	buru	VERB	Mood=Ind|Voice=Act
Resistance	Resistance	PROPN	_
dieksekusi	eksekusi	VERB	Mood=Ind|Voice=Pass
1945	1945	NUM	NumType=Card
De	De	PROPN	_
Gaulle	Gaulle	PROPN	_
memerintahkan	perintah	VERB	Mood=Ind|Voice=Act
penunjukan	tunjuk	NOUN	Number=Sing
sayang	sayang	ADJ	_
berlebihan	lebih	ADJ	_
Churchill	Churchill	PROPN	_
persetujuan	setuju	NOUN	Number=Sing
mengisahkan	kisah	VERB	Mood=Ind|Voice=Act
Carangi	Carangi	PROPN	_
kecanduan	candu	NOUN	Number=Sing
heroin	heroin	NOUN	Number=Sing
kemerosotan	perosot	NOUN	Number=Sing
AIDS	aids	NOUN	Abbr=Yes
1980-an	1980	NUM	NumType=Card
diselesaikan	selesai	VERB	Mood=Ind|Voice=Pass
lambat	lambat	ADJ	_
B-29	B-29	PROPN	_
dilengkapi	lengkap	VERB	Mood=Ind|Voice=Pass
Eagle	Eagle	PROPN	_
terlambat	lambat	VERB	Mood=Ind|Voice=Pass
Sistem	sistem	NOUN	Number=Sing
radar	radar	NOUN	Number=Sing
Alvarez	Alvarez	PROPN	_
aviasi	aviasi	NOUN	Number=Sing
pengangkutan	angkut	NOUN	Number=Sing
Berlin	Berlin	PROPN	_
pascaperang	pascaperang	ADJ	_
Ground	Ground	PROPN	_
Controlled	Controlled	PROPN	_
Approach	Approach	PROPN	_
GCA	GCA	PROPN	Abbr=Yes
antena	antena	NOUN	Number=Sing
dwikutub	dwikutub	NOUN	Number=Sing
resolusi	resolusi	NOUN	Number=Sing
operator	operator	NOUN	Number=Sing
layar	layar	NOUN	Number=Sing
presisi	presisi	NOUN	Number=Sing
memandu	pandu	VERB	Mood=Ind|Voice=Act
landasan	landas	NOUN	Number=Sing
terbang	terbang	VERB	Mood=Ind|Voice=Act
mentransmisikan	transmisi	VERB	Mood=Ind|Voice=Act
lisan	lisan	ADJ	_
pilot	pilot	NOUN	Number=Sing
terlatih	latih	ADJ	_
Aliansi	Aliansi	PROPN	_
Pembebasan	Pembebasan	PROPN	_
Kongo	Kongo	PROPN	_
menangkap	tangkap	VERB	Mood=Ind|Voice=Act
Lubumbashi	Lubumbashi	PROPN	_
Ketinggian	tinggi	NOUN	Number=Sing
mendinginkan	dingin	VERB	Mood=Ind|Voice=Act
didinginkan	dingin	VERB	Mood=Ind|Voice=Pass
Kesehatan	sehat	NOUN	Number=Sing
output	output	NOUN	Number=Sing
Hitchcock	Hitchcock	PROPN	_
mengalami	alam	VERB	Mood=Ind|Voice=Act
talenta-talenta	talenta	NOUN	Number=Plur
poster	poster	NOUN	Number=Sing
Bill	Bill	PROPN	_
Gold	Gold	PROPN	_
Saul	Saul	PROPN	_
pertentangan	tentang	NOUN	Number=Sing
mental	mental	NOUN	Number=Sing
mencengkeram	cengkeram	VERB	Mood=Ind|Voice=Act
Herzl	Herzl	PROPN	_
merindukan	rindu	VERB	Mood=Ind|Voice=Act
kesuksesan	sukses	NOUN	Number=Sing
Maret	Maret	PROPN	_
1896	1896	NUM	NumType=Card
dikunjungi	kunjung	VERB	Mood=Ind|Voice=Pass
Pendeta	Pendeta	PROPN	_
William	William	PROPN	_
Hechler	Hechler	PROPN	_
pelayan	layan	NOUN	Number=Sing
Anglican	Anglican	PROPN	_
Kedutaan	Kedutaan	PROPN	_
mahir	mahir	ADJ	_
Lenny	Lenny	PROPN	_
bujangan	bujang	NOUN	Number=Sing
gigih	gigih	ADJ	_
beruntung	untung	VERB	Mood=Ind|Voice=Act
urusan	urus	NOUN	Number=Sing
kesempatan	sempat	NOUN	Number=Sing
disiratkan	sirat	VERB	Mood=Ind|Voice=Pass
menyamar	samar	VERB	Mood=Ind|Voice=Act
Homer	Homer	PROPN	_
Memutuskan	putus	VERB	Mood=Ind|Voice=Act
Winstone	Winstone	PROPN	_
mendaftar	daftar	VERB	Mood=Ind|Voice=Act
Corona	Corona	PROPN	_
Stage	Stage	PROPN	_
Academy	Academy	PROPN	_
Hammersmith	Hammersmith	PROPN	_
Elaine	Elaine	PROPN	_
That	That	PROPN	_
Summer	Summer	PROPN	_
1979	1979	NUM	NumType=Card
dinyatakan	nyata	VERB	Mood=Ind|Voice=Pass
bangkrut	bangkrut	VERB	Mood=Ind|Voice=Act
1988	1988	NUM	NumType=Card
19	19	NUM	NumType=Card
March	March	PROPN	_
1993	1993	NUM	NumType=Card
Disney	Disney	PROPN	_
Universal	Universal	PROPN	_
cipta	cipta	NOUN	Number=Sing
Oswald	Oswald	PROPN	_
Honorary	Honorary	PROPN	_
Award	Award	PROPN	_
miniatur	miniatur	NOUN	Number=Sing
Kartu	kartu	NOUN	Number=Sing
tunjangan	tunjang	NOUN	Number=Sing
ATM	ATM	NOUN	Abbr=Yes
seragam	ragam	NOUN	Number=Sing
merenovasi	renovasi	VERB	Mood=Ind|Voice=Act
saingan	saing	NOUN	Number=Sing
Prabowo	Prabowo	PROPN	_
Subianto	Subianto	PROPN	_
kemenangan	menang	NOUN	Number=Sing
Indonesia	Indonesia	PROPN	_
bingung	bingung	ADJ	_
Jokowi	Jokowi	PROPN	_
Yudhoyono	Yudhoyono	PROPN	_
keputusan	putus	NOUN	Number=Sing
menaikkan	naik	VERB	Mood=Ind|Voice=Act
bakar	bakar	VERB	Mood=Ind|Voice=Act
minyak	minyak	NOUN	Number=Sing
subsidi	subsidi	NOUN	Number=Sing
Biografi	biografi	NOUN	Number=Sing
Kim	Kim	PROPN	_
opera	opera	NOUN	Number=Sing
mengerjakan	kerja	VERB	Mood=Ind|Voice=Act
musikal	musikal	ADJ	_
rinci	rinci	ADJ	_
Alexander	Alexander	PROPN	_
berkompromi	kompromi	VERB	Mood=Ind|Voice=Act
kuliah	kuliah	VERB	Mood=Ind|Voice=Act
universitas	universitas	NOUN	Number=Sing
mempelajari	ajar	VERB	Mood=Ind|Voice=Act
Barrie	Barrie	PROPN	_
Edinburgh	Edinburgh	PROPN	_
ulasan	ulas	NOUN	Number=Sing
Evening	Evening	PROPN	_
Courant	Courant	PROPN	_
lulus	lulus	VERB	Mood=Ind|Voice=Act
M.A.	M.A.	PROPN	Abbr=Yes
1882	1882	NUM	NumType=Card
melamar	lamar	VERB	Mood=Ind|Voice=Act
lowongan	lowong	NOUN	Number=Sing
saudari	saudari	NOUN	Number=Sing
Scotsman	Scotsman	PROPN	_
staf	staf	NOUN	Number=Sing
Nottingham	Nottingham	PROPN	_
Journal	Journal	PROPN	_
Kirriemuir	Kirriemuir	PROPN	_
3000	3000	NUM	NumType=Card
dicetak	cetak	VERB	Mood=Ind|Voice=Pass
2009	2009	NUM	NumType=Card
penjualan	jual	NOUN	Number=Sing
Power	Power	PROPN	_
Now	Now	PROPN	_
Earth	Earth	PROPN	_
cendekiawan	cendekiawan	NOUN	Number=Sing
mengkritik	kritik	VERB	Mood=Ind|Voice=Act
pengajaran	ajar	NOUN	Number=Sing
Tolle	Tolle	PROPN	_
Antara	antara	ADP	_
1991	1991	NUM	NumType=Card
mengelola	kelola	VERB	Mood=Ind|Voice=Act
ketidakmampuan	kemampuan	NOUN	Number=Sing
Karya	karya	NOUN	Number=Sing
nonfiksi	nonfiksi	ADJ	_
Douglas	Douglas	PROPN	_
Countess	Countess	PROPN	_
Lennox	Lennox	PROPN	_
fiksi	fiksi	NOUN	Number=Sing
kurva	kurva	NOUN	Number=Sing
pembelajaran	ajar	NOUN	Number=Sing
pikiran	pikir	NOUN	Number=Sing
menghindari	hindar	VERB	Mood=Ind|Voice=Act
dilema	dilema	NOUN	Number=Sing
serupa	rupa	ADJ	_
Jasmine	Jasmine	PROPN	_
dianimasi	animasi	VERB	Mood=Ind|Voice=Pass
studio	studio	NOUN	Number=Sing
finalisasi	finalisasi	NOUN	Number=Sing
penampilan	tampil	NOUN	Number=Sing
non-kulit-putih	non-kulit-putih	ADJ	_
tematis	tematis	ADJ	_
hak-hak	hak	NOUN	Number=Plur
toleransi	toleransi	NOUN	Number=Sing
rasial	rasial	ADJ	_
hierarki	hierarki	NOUN	Number=Sing
pengejaran	kejar	NOUN	Number=Sing
kebahagiaan	bahagia	NOUN	Number=Sing
pengakuan	aku	NOUN	Number=Sing
tahan	tahan	ADJ	_
semasa	masa	ADP	_
komunis	komunis	NOUN	Number=Sing
Polandia	Polandia	PROPN	_
Really	Really	PROPN	_
Love	Love	PROPN	_
top	top	NOUN	Number=Sing
top	top	ADJ	_
Shaky	Shaky	PROPN	_
single	single	NOUN	Number=Sing
terkait	kait	VERB	Mood=Ind|Voice=Pass
Geyer	Geyer	PROPN	_
menikmati	nikmat	VERB	Mood=Ind|Voice=Act
Los	Los	PROPN	_
Angeles	Angeles	PROPN	_
1984	1984	NUM	NumType=Card
menembus	tembus	VERB	Mood=Ind|Voice=Act
kemajuan	maju	NOUN	Number=Sing
mentok	mentok	VERB	Mood=Ind|Voice=Act
Billboard	Billboard	PROPN	_
200	200	NUM	NumType=Card
96	96	NUM	NumType=Card
Thought	Thought	PROPN	_
Ya	Ya	PROPN	_
Knew	Knew	PROPN	_
album	album	NOUN	Number=Sing
pemecatan	pecat	NOUN	Number=Sing
Peniston	Peniston	PROPN	_
Glinda	Glinda	PROPN	_
the	the	PROPN	_
Good	Good	PROPN	_
Witch	Witch	PROPN	_
produksi	produksi	NOUN	Number=Sing
teater	teater	NOUN	Number=Sing
Wiz	Wiz	PROPN	_
Wilkes	Wilkes	PROPN	_
ditendang	tendang	VERB	Mood=Ind|Voice=Pass
Commons	Commons	PROPN	_
pencalonan	calon	NOUN	Number=Sing
peraih	raih	NOUN	Number=Sing
terbanyak	banyak	ADJ	Degree=Sup
Grafton	Grafton	PROPN	_
1770	1770	NUM	NumType=Card
Tories	Tories	PROPN	_
Lord	Lord	PROPN	_
George	George	PROPN	_
taat	taat	ADJ	_
berjam-jam	jam	NOUN	Number=Plur
berdoa	doa	VERB	Mood=Ind|Voice=Act
kesalehan	saleh	NOUN	Number=Sing
dimiliki	milik	VERB	Mood=Ind|Voice=Pass
saudara	saudara	NOUN	Number=Sing
kendur	kendur	ADJ	_
Prince	Prince	PROPN	_
Duke	Duke	PROPN	_
Cumberland	Cumberland	PROPN	_
Strathearn	Strathearn	PROPN	_
terungkap	ungkap	VERB	Mood=Ind|Voice=Pass
pezinah	zina	NOUN	Number=Sing
menikahi	nikah	VERB	Mood=Ind|Voice=Act
janda	janda	NOUN	Number=Sing
Anne	Anne	PROPN	_
Horton	Horton	PROPN	_
Album	album	NOUN	Number=Sing
Wild	Wild	PROPN	_
West	West	PROPN	_
1981	1981	NUM	NumType=Card
terlaris	laris	ADJ	Degree=Sup
nyaris	nyaris	ADV	_
2012	2012	NUM	NumType=Card
band	band	NOUN	Number=Sing
Sigur	Sigur	PROPN	_
Rós	Rós	PROPN	_
Fjögur	Fjögur	PROPN	_
Píanó	Píanó	PROPN	_
dibintangi	bintang	VERB	Mood=Ind|Voice=Pass
LaBeouf	LaBeouf	PROPN	_
telanjang	telanjang	VERB	Mood=Ind|Voice=Act
Post	Post	PROPN	_
Dispatch	Dispatch	PROPN	_
terbakar	bakar	VERB	Mood=Ind|Voice=Pass
Kenseth	Kenseth	PROPN	_
menang	menang	VERB	Mood=Ind|Voice=Act
Elliott	Elliott	PROPN	_
ayah	ayah	NOUN	Number=Sing
balapan	balap	NOUN	Number=Sing
2003	2003	NUM	NumType=Card
klasemen	klasemen	NOUN	Number=Sing
33	33	NUM	NumType=Card
36	36	NUM	NumType=Card
juara	juara	NOUN	Number=Sing
NASCAR	NASCAR	PROPN	Abbr=Yes
Winston	Winston	PROPN	_
pembalap	balap	NOUN	Number=Sing
Rafferty	Rafferty	PROPN	_
1990-an	1990	NUM	NumType=Card
digambarkan	gambar	VERB	Mood=Ind|Voice=Pass
musisi	musisi	NOUN	Number=Sing
Tom	Tom	PROPN	_
Robinson	Robinson	PROPN	_
sosok	sosok	NOUN	Number=Sing
On	On	PROPN	_
a	a	PROPN	_
Wing	Wing	PROPN	_
Prayer	Prayer	PROPN	_
mempertemukan	temu	VERB	Mood=Ind|Voice=Act
rekan	rekan	NOUN	Number=Sing
Stealers	Stealers	PROPN	_
Wheel	Wheel	PROPN	_
Egan	Egan	PROPN	_
ditulis	tulis	VERB	Mood=Ind|Voice=Pass
Jim	Jim	PROPN	_
menandatangani	tandatangan	VERB	Mood=Ind|Voice=Act
menandatangani	tanda-tangan	VERB	Mood=Ind|Voice=Act
Decca	Decca	PROPN	_
Records	Records	PROPN	_
Humblebums	Humblebums	PROPN	_
Her	Her	PROPN	_
Father	Father	PROPN	_
Did	Did	PROPN	_
n't	n't	PROPN	_
Like	Like	PROPN	_
Me	Me	PROPN	_
Anyway	Anyway	PROPN	_
Over	Over	PROPN	_
My	My	PROPN	_
Head	Head	PROPN	_
1994	1994	NUM	NumType=Card
rekaman	rekam	NOUN	Number=Sing
diproduksi	produksi	VERB	Mood=Ind|Voice=Pass
Hugh	Hugh	PROPN	_
Murphy	Murphy	PROPN	_
1998	1998	NUM	NumType=Card
Sedikitnya	sedikit	ADV	_
330.000	330.000	NUM	NumType=Card
teknisi	teknisi	NOUN	Number=Sing
Stalin	Stalin	PROPN	_
Abakumov	Abakumov	PROPN	_
MGB	MGB	PROPN	Abbr=Yes
menandingi	tanding	VERB	Mood=Ind|Voice=Act
Beria	Beria	PROPN	_
kementerian	menteri	NOUN	Number=Sing
Pola	pola	NOUN	Number=Sing
Petén	Petén	PROPN	_
Uaxactun	Uaxactun	PROPN	_
penyesuaian	suai	NOUN	Number=Sing
Maya	Maya	PROPN	_
Artikel	artikel	NOUN	Number=Sing
Thompson	Thompson	PROPN	_
mengasumsikan	asumsi	VERB	Mood=Ind|Voice=Act
Layar	layar	NOUN	Number=Sing
diwakili	wakil	VERB	Mood=Ind|Voice=Pass
ikonografi	ikonografi	NOUN	Number=Sing
Mesoamerika	Mesoamerika	PROPN	_
prasejarah	prasejarah	NOUN	Number=Sing
diteorikan	teori	VERB	Mood=Ind|Voice=Pass
moda	moda	NOUN	Number=Sing
transportasi	transportasi	NOUN	Number=Sing
Starlin	Starlin	PROPN	_
plot	plot	NOUN	Number=Sing
terbitan	terbit	NOUN	Number=Sing
mengembangkan	kembang	VERB	Mood=Ind|Voice=Act
terperinci	rinci	VERB	Mood=Ind|Voice=Pass
terperinci	perinci	VERB	Mood=Ind|Voice=Pass
jahat	jahat	ADJ	_
Thanos	Thanos	PROPN	_
tersebar	sebar	VERB	Mood=Ind|Voice=Pass
judul	judul	NOUN	Number=Sing
Marvel	Marvel	PROPN	_
bersamaan	sama	VERB	Mood=Ind|Voice=Act
menyumbangkan	sumbang	VERB	Mood=Ind|Voice=Act
antologi	antologi	NOUN	Number=Sing
Star	Star	PROPN	_
Reach	Reach	PROPN	_
Melalui	lalu	ADP	_
Mishima	Mishima	PROPN	_
Tokugawa	Tokugawa	PROPN	_
Ieyasu	Ieyasu	PROPN	_
1955	1955	NUM	NumType=Card
angkat	angkat	VERB	Mood=Ind|Voice=Act
sesi	sesi	NOUN	Number=Sing
terganggu	ganggu	VERB	Mood=Ind|Voice=Pass
15	15	NUM	NumType=Card
brand	brand	NOUN	Number=Sing
nasionalisme	nasionalisme	NOUN	Number=Sing
individual	individual	ADJ	_
hayat	hayat	NOUN	Number=Sing
2011	2011	NUM	NumType=Card
Blunt	Blunt	PROPN	_
ditunjuk	tunjuk	VERB	Mood=Ind|Voice=Pass
parfum	parfum	NOUN	Number=Sing
Yves	Yves	PROPN	_
Laurent	Laurent	PROPN	_
membintangi	bintang	VERB	Mood=Ind|Voice=Act
komedi	komedi	NOUN	Number=Sing
berjudul	judul	VERB	Mood=Ind|Voice=Act
Salmon	Salmon	PROPN	_
Fishing	Fishing	PROPN	_
in	in	PROPN	_
Yemen	Yemen	PROPN	_
Lasse	Lasse	PROPN	_
Hallström	Hallström	PROPN	_
Ewan	Ewan	PROPN	_
McGregor	McGregor	PROPN	_
Kristin	Kristin	PROPN	_
Scott	Scott	PROPN	_
Muppets	Muppets	PROPN	_
resepsionis	resepsionis	NOUN	Number=Sing
Miss	Miss	PROPN	_
Piggy	Piggy	PROPN	_
Five-Year	Five-Year	PROPN	_
Engagement	Engagement	PROPN	_
Nicholas	Nicholas	PROPN	_
Stoller	Stoller	PROPN	_
Jason	Jason	PROPN	_
Segel	Segel	PROPN	_
Looper	Looper	PROPN	_
Rian	Rian	PROPN	_
Johnson	Johnson	PROPN	_
Bruce	Bruce	PROPN	_
Willis	Willis	PROPN	_
Gordon-Levitt	Gordon-Levitt	PROPN	_
Valentino	Valentino	PROPN	_
menjauhkan	jauh	VERB	Mood=Ind|Voice=Act
potret	potret	NOUN	Number=Sing
stereotipe	stereotipe	NOUN	Number=Sing
Schenck	Schenck	PROPN	_
tertarik	tarik	VERB	Mood=Ind|Voice=Pass
men-casting	casting	VERB	Mood=Ind|Voice=Act
Norma	Norma	PROPN	_
Talmadge	Talmadge	PROPN	_
lawan	lawan	NOUN	Number=Sing
Romeo	Romeo	PROPN	_
Juliet	Juliet	PROPN	_
Halifax	Halifax	PROPN	_
diam-diam	diam	ADV	_
Hitler	Hitler	PROPN	_
Berbicara	bicara	VERB	Mood=Ind|Voice=Act
hadapan	hadap	NOUN	Number=Sing
Kabinet	kabinet	NOUN	Number=Sing
Chamberlain	Chamberlain	PROPN	_
Ceko	Ceko	PROPN	_
menembak	tembak	VERB	Mood=Ind|Voice=Act
Sudeten	Sudeten	PROPN	_
menyeberang	seberang	VERB	Mood=Ind|Voice=Act
Marcelle	Marcelle	PROPN	_
ditinggal	tinggal	VERB	Mood=Ind|Voice=Pass
kamar	kamar	NOUN	Number=Sing
Piaf	Piaf	PROPN	_
Mômone	Mômone	PROPN	_
jalanan	jalan	NOUN	Number=Sing
menyanyi	nyanyi	VERB	Mood=Ind|Voice=Act
terlupakan	lupa	VERB	Mood=Ind|Voice=Pass
Smith	Smith	PROPN	_
Tema	tema	NOUN	Number=Sing
novel	novel	NOUN	Number=Sing
Skylark	Skylark	PROPN	_
pelopor	pelopor	NOUN	Number=Sing
1926	1926	NUM	NumType=Card
Meyer	Meyer	PROPN	_
menyurati	surat	VERB	Mood=Ind|Voice=Act
Irène	Irène	PROPN	_
Joliot-Curie	Joliot-Curie	PROPN	_
Rona	Rona	PROPN	_
laboratorium	laboratorium	NOUN	Number=Sing
sampel	sampel	NOUN	Number=Sing
polonium	polonium	NOUN	Number=Sing
Hans	Hans	PROPN	_
Pettersson	Pettersson	PROPN	_
membiayai	biaya	VERB	Mood=Ind|Voice=Act
pemisahan	pisah	NOUN	Number=Sing
Curie	Curie	PROPN	_
Institute	Institute	PROPN	_
disempurnakan	sempurna	VERB	Mood=Ind|Voice=Pass
menyiapkan	siap	VERB	Mood=Ind|Voice=Act
alfa	alfa	NOUN	Number=Sing
Mendapatkan	dapat	VERB	Mood=Ind|Voice=Act
Radium	Radium	PROPN	_
wadah	wadah	NOUN	Number=Sing
cakram	cakram	NOUN	Number=Sing
Wadah	wadah	NOUN	Number=Sing
spesimen	spesimen	NOUN	Number=Sing
selanjutnya	lanjut	ADV	_
Institut	institut	NOUN	Number=Sing
CTV	CTV	PROPN	_
Montreal	Montreal	PROPN	_
pembawa	bawa	NOUN	Number=Sing
tamu	tamu	NOUN	Number=Sing
Kemudian	kemudian	ADV	_
Sara	Sara	PROPN	_
Errani	Errani	PROPN	_
Bouchard	Bouchard	PROPN	_
Cecily	Cecily	PROPN	_
Plantagenet	Plantagenet	PROPN	_
Edward	Edward	PROPN	_
IV	iv	ADJ	NumType=Ord
Joan	Joan	PROPN	_
Gaunt	Gaunt	PROPN	_
1399	1399	NUM	NumType=Card
Ksatria	Ksatria	PROPN	_
Lyvet	Lyvet	PROPN	_
dilepaskan	lepas	VERB	Mood=Ind|Voice=Pass
pengikut	ikut	NOUN	Number=Sing
dimasukkan	masuk	VERB	Mood=Ind|Voice=Pass
Menara	menara	NOUN	Number=Sing
Belum	belum	PART	Polarity=Neg
bercerai	cerai	VERB	Mood=Ind|Voice=Act
aktris	aktris	NOUN	Number=Sing
Gloria	Gloria	PROPN	_
Holden	Holden	PROPN	_
keretakan	retak	NOUN	Number=Sing
adik	adik	NOUN	Number=Sing
Humphrey	Humphrey	PROPN	_
Bogart	Bogart	PROPN	_
playboy	playboy	NOUN	Number=Sing
Sabrina	Sabrina	PROPN	_
1954	1954	NUM	NumType=Card
Audrey	Audrey	PROPN	_
Hepburn	Hepburn	PROPN	_
mengejar	kejar	VERB	Mood=Ind|Voice=Act
siklus	siklus	NOUN	Number=Sing
Kampanye	kampanye	NOUN	Number=Sing
1980	1980	NUM	NumType=Card
Reagan	Reagan	PROPN	_
inkumben	inkumben	ADJ	_
Jimmy	Jimmy	PROPN	_
Carter	Carter	PROPN	_
dilaksanakan	laksana	VERB	Mood=Ind|Voice=Pass
krisis	krisis	NOUN	Number=Sing
sandera	sandera	NOUN	Number=Sing
Iran	Iran	PROPN	_
1952	1952	NUM	NumType=Card
34	34	NUM	NumType=Card
Perwakilan	Perwakilan	PROPN	_
pulang	pulang	VERB	Mood=Ind|Voice=Act
percobaan	coba	NOUN	Number=Sing
Tuhan	Tuhan	PROPN	_
Bloch	Bloch	PROPN	_
prihatin	prihatin	ADJ	_
harapan	harap	NOUN	Number=Sing
prinsip	prinsip	NOUN	Number=Sing
pemandu	pandu	NOUN	Number=Sing
Marxisme	marxisme	PROPN	Number=Sing
menekankan	tekan	VERB	Mood=Ind|Voice=Act
humanisme	humanisme	NOUN	Number=Sing
tersirat	sirat	VERB	Mood=Ind|Voice=Pass
melekat	lekat	VERB	Mood=Ind|Voice=Act
mistis	mistis	ADJ	_
teologi	teologi	NOUN	Number=Sing
dikonstruksi	konstruksi	VERB	Mood=Ind|Voice=Pass
mempertimbangkan	timbang	VERB	Mood=Ind|Voice=Act
Pebe	Pebe	PROPN	_
memindahkan	pindah	VERB	Mood=Ind|Voice=Act
Nashville	Nashville	PROPN	_
Tennessee	Tennessee	PROPN	_
publikasi	publikasi	NOUN	Number=Sing
penulisan	tulis	NOUN	Number=Sing
Kesha	Kesha	PROPN	_
menemui	temu	VERB	Mood=Ind|Voice=Act
David	David	PROPN	_
Gamson	Gamson	PROPN	_
produser	produser	NOUN	Number=Sing
kagumi	kagum	VERB	Mood=Ind|Voice=Act
Scritti	Scritti	PROPN	_
Politti	Politti	PROPN	_
setuju	setuju	VERB	Mood=Ind|Voice=Act
memproduseri	produser	VERB	Mood=Ind|Voice=Act
Per	per	ADP	_
kabar	kabar	NOUN	Number=Sing
terikat	ikat	VERB	Mood=Ind|Voice=Pass
Wright	Wright	PROPN	_
Poole	Poole	PROPN	_
Dorset	Dorset	PROPN	_
Wells	Wells	PROPN	_
Somerset	Somerset	PROPN	_
seniman	seniman	NOUN	Number=Sing
komik	komik	NOUN	Number=Sing
kontributor	kontributor	NOUN	Number=Sing
storyboard	storyboard	X	_
konseptual	konseptual	ADJ	_
gambar-gambar	gambar	NOUN	Number=Plur
promosi	promosi	NOUN	Number=Sing
Edgar	Edgar	PROPN	_
sesama	sama	NOUN	Number=Sing
Garth	Garth	PROPN	_
Jennings	Jennings	PROPN	_
cameo	cameo	NOUN	Number=Sing
Hitchhiker	Hitchhiker	PROPN	_
's	's	PROPN	_
Guide	Guide	PROPN	_
to	to	PROPN	_
Galaxy	Galaxy	PROPN	_
Son	Son	PROPN	_
Rambow	Rambow	PROPN	_
Powers	Powers	PROPN	_
Albania	Albania	PROPN	_
konferensi	konferensi	NOUN	Number=Sing
keenam	enam	NUM	NumType=Card
merdeka	merdeka	ADJ	_
otonom	otonom	ADJ	_
Otttoman	Otttoman	PROPN	_
teritorial	teritorial	ADJ	_
menyadari	sadar	VERB	Mood=Ind|Voice=Act
30	30	NUM	NumType=Card
1913	1913	NUM	NumType=Card
diklaim	klaim	VERB	Mood=Ind|Voice=Pass
terlepas	lepas	VERB	Mood=Ind|Voice=Pass
komposisi	komposisi	NOUN	Number=Sing
Petugas	tugas	NOUN	Number=Sing
menundukkan	tunduk	VERB	Mood=Ind|Voice=Act
kejadian	jadi	NOUN	Number=Sing
Salaman	Salaman	PROPN	_
veteran	veteran	NOUN	Number=Sing
Mohammed	Mohammed	PROPN	_
al-Jadaan	al-Jadaan	PROPN	_
Minyak	minyak	NOUN	Number=Sing
gandum	gandum	NOUN	Number=Sing
menginvestasikan	investasi	VERB	Mood=Ind|Voice=Act
71	71	NUM	NumType=Card
goal	goal	NOUN	Number=Sing
137	137	NUM	NumType=Card
mencetak	cetak	VERB	Mood=Ind|Voice=Act
rekor	rekor	NOUN	Number=Sing
gol	gol	NOUN	Number=Sing
DFB	DFB	NOUN	Abbr=Yes
debit	debit	NOUN	Number=Sing
Essen	Essen	PROPN	_
pensiunan	pensiun	NOUN	Number=Sing
Juru	juru	NOUN	Number=Sing
mengesampingkan	samping	VERB	Mood=Ind|Voice=Act
diselidiki	selidik	VERB	Mood=Ind|Voice=Pass
menghemat	hemat	VERB	Mood=Ind|Voice=Act
Foto	foto	NOUN	Number=Sing
bilah	bilah	NOUN	Number=Sing
sentuh	sentuh	VERB	Mood=Ind|Voice=Act
tipis	tipis	ADJ	_
keyboard	keyboard	NOUN	Number=Sing
diantisipasi	antisipasi	VERB	Mood=Ind|Voice=Pass
rumor	rumor	NOUN	Number=Sing
Orang	orang	NOUN	Number=Sing
pembiakan	biak	NOUN	Number=Sing
Parker	Parker	PROPN	_
Badan	Badan	PROPN	_
Rahasia	Rahasia	PROPN	_
Britania	Britania	PROPN	_
Raya	Raya	PROPN	_
penangguhan	tangguh	NOUN	Number=Sing
Undang-undang	undang	NOUN	Number=Sing
NATO	NATO	PROPN	Abbr=Yes
2000	2000	NUM	NumType=Card
menghapus	hapus	VERB	Mood=Ind|Voice=Act
rugi	rugi	ADJ	_
timbul	timbul	VERB	Mood=Ind|Voice=Act
karyawan	karyawan	NOUN	Number=Sing
Turki	Turki	PROPN	_
maka	maka	SCONJ	_
dewan	dewan	NOUN	Number=Sing
basi	basi	ADJ	_
memuaskan	puas	VERB	Mood=Ind|Voice=Act
Kühn	kühn	PROPN	_
menggelengkan	geleng	VERB	Mood=Ind|Voice=Act
Die	Die	PROPN	_
ZEIT	ZEIT	PROPN	_
pertama-tama	pertama	ADV	_
arus	arus	NOUN	Number=Sing
kas	kas	NOUN	Number=Sing
dipercaya	percaya	VERB	Mood=Ind|Voice=Pass
Jam	jam	NOUN	Number=Sing
mempesona	pesona	VERB	Mood=Ind|Voice=Act
organ	organ	NOUN	Number=Sing
menakutkan	takut	VERB	Mood=Ind|Voice=Act
hit	hit	NOUN	Number=Sing
hit	hit	ADJ	_
Monster	Monster	PROPN	_
Mash	Mash	PROPN	_
Von	Von	PROPN	_
Beust	Beust	PROPN	_
membenarkan	benar	VERB	Mood=Ind|Voice=Act
perencanaan	rencana	NOUN	Number=Sing
Simon	Simon	PROPN	_
Krätschmer	Krätschmer	PROPN	_
meraba-raba	raba	VERB	Mood=Ind|Voice=Act
barak	barak	NOUN	Number=Sing
bobrok	bobrok	ADJ	_
seram	seram	ADJ	_
keajaiban	ajaib	NOUN	Number=Sing
menempati	tempat	VERB	Mood=Ind|Voice=Act
Produksi	produksi	NOUN	Number=Sing
ponsel	ponsel	NOUN	Number=Sing
cerdas	cerdas	ADJ	_
dihentikan	henti	VERB	Mood=Ind|Voice=Pass
bebek	bebek	NOUN	Number=Sing
Generasi	generasi	NOUN	Number=Sing
skenario	skenario	NOUN	Number=Sing
situasi	situasi	NOUN	Number=Sing
bodoh	bodoh	ADJ	_
jutaan	juta	NUM	NumType=Card
pemirsa	pirsa	NOUN	Number=Sing
Vine	Vine	PROPN	_
detik	detik	NOUN	Number=Sing
Kerber	Kerber	PROPN	_
final	final	NOUN	Number=Sing
dinyana	nyana	VERB	Mood=Ind|Voice=Pass
sensasi	sensasi	NOUN	Number=Sing
Australian	Australian	PROPN	_
Open	Open	PROPN	_
28	28	NUM	NumType=Card
Serena	Serena	PROPN	_
Williams	Williams	PROPN	_
Sekarang	sekarang	ADV	_
cuma	cuma	ADV	_
berselisih	selisih	VERB	Mood=Ind|Voice=Act
alarm	alarm	NOUN	Number=Sing
Sudah	sudah	AUX	_
iman	iman	NOUN	Number=Sing
Kristiani	kristiani	ADJ	_
ditanam	tanam	VERB	Mood=Ind|Voice=Pass
kapur	kapur	NOUN	Number=Sing
peristirahatan	istirahat	NOUN	Number=Sing
mengiklankan	iklan	VERB	Mood=Ind|Voice=Act
ditanyai	tanya	VERB	Mood=Ind|Voice=Pass
mengenal	kenal	VERB	Mood=Ind|Voice=Act
Günter	Günter	PROPN	_
Bruyn	Bruyn	PROPN	_
bersaudara	saudara	VERB	Mood=Ind|Voice=Act
Penyelidik	selidik	NOUN	Number=Sing
kecelakaan	celaka	NOUN	Number=Sing
Larry	Larry	PROPN	_
Vance	Vance	PROPN	_
SPIEGEL	SPIEGEL	PROPN	_
bermaksud	maksud	VERB	Mood=Ind|Voice=Act
mendaratkan	darat	VERB	Mood=Ind|Voice=Act
supaya	supaya	SCONJ	_
tenggelam	tenggelam	VERB	Mood=Ind|Voice=Act
Ahli	ahli	NOUN	Number=Sing
kesimpulan	simpul	NOUN	Number=Sing
flap	flap	X	_
pendaratan	darat	NOUN	Number=Sing
Boeing	Boeing	PROPN	_
terdampar	dampar	VERB	Mood=Ind|Voice=Pass
Tanzania	Tanzania	PROPN	_
Masalah	masalah	NOUN	Number=Sing
Barroso	Barroso	PROPN	_
Penggantian	ganti	NOUN	Number=Sing
Barrosos	Barrosos	PROPN	_
kegegeran	geger	NOUN	Number=Sing
Penangkapan	tangkap	NOUN	Number=Sing
kelanjutan	lanjut	NOUN	Number=Sing
Dündar	Dündar	PROPN	_
Dündar	dündar	PROPN	_
transaksi	transaksi	NOUN	Number=Sing
Aoun	Aoun	PROPN	_
Hariri	Hariri	PROPN	_
mendekatkan	dekat	VERB	Mood=Ind|Voice=Act
faksi	faksi	NOUN	Number=Sing
Suami	suami	NOUN	Number=Sing
Gedung	Gedung	PROPN	_
Putih	Putih	PROPN	_
Hillary	Hillary	PROPN	_
mengampuni	ampun	VERB	Mood=Ind|Voice=Act
Rich	Rich	PROPN	_
2001	2001	NUM	NumType=Card
soal	soal	ADP	_
pengertian	arti	NOUN	Number=Sing
pergerakan	gerak	NOUN	Number=Sing
Erdogan	Erdogan	PROPN	_
Adnan	Adnan	PROPN	_
Z.	Z.	PROPN	Abbr=Yes
Amin	Amin	PROPN	_
International	international	X	Foreign=Yes
International	International	PROPN	_
Organization	organization	X	Foreign=Yes
for	for	X	Foreign=Yes
Renewable	renewable	X	Foreign=Yes
Energies	energies	X	Foreign=Yes
IRENA	IRENA	PROPN	Abbr=Yes
Pembangkit	bangkit	NOUN	Number=Sing
berbasis	basis	VERB	Mood=Ind|Voice=Act
Angka-angka	angka	NOUN	Number=Plur
saham	saham	NOUN	Number=Sing
benturan	bentur	NOUN	Number=Sing
ledakan	ledak	NOUN	Number=Sing
lukisan	lukis	NOUN	Number=Sing
karya	karya	NOUN	Number=Sing
Lucas	Lucas	PROPN	_
Cranach	Cranach	PROPN	_
Elder	Elder	PROPN	_
dipajang	pajang	VERB	Mood=Ind|Voice=Pass
Oleh	oleh	ADP	_
menjengkelkan	jengkel	VERB	Mood=Ind|Voice=Act
DPA	DPA	PROPN	Abbr=Yes
diaktifkan	aktif	VERB	Mood=Ind|Voice=Pass
label	label	NOUN	Number=Sing
GEMA	GEMA	PROPN	Abbr=Yes
YouTube	YouTube	PROPN	_
Kontaminan	kontaminan	NOUN	Number=Sing
kontaminan	kontaminan	NOUN	Number=Sing
jangka	jangka	NOUN	Number=Sing
otak	otak	NOUN	Number=Sing
menggolongkan	golong	VERB	Mood=Ind|Voice=Act
Warisan	Warisan	PROPN	_
Alam	Alam	PROPN	_
Nasional	Nasional	PROPN	_
berprioritas	prioritas	VERB	Mood=Ind|Voice=Act
mendokumentasikan	dokumentasi	VERB	Mood=Ind|Voice=Act
2005	2005	NUM	NumType=Card
koalisi	koalisi	NOUN	Number=Sing
Mr.	Mr.	PROPN	_
Comey	Comey	PROPN	_
dikomentari	komentar	VERB	Mood=Ind|Voice=Pass
Demokrat	Demokrat	PROPN	_
meyakinkan	yakin	VERB	Mood=Ind|Voice=Act
diperiksa	periksa	VERB	Mood=Ind|Voice=Pass
nuklir	nuklir	NOUN	Number=Sing
ejek	ejek	VERB	Mood=Ind|Voice=Act
pukul	pukul	NOUN	Number=Sing
23.45	23.45	NUM	NumType=Card
Ms.	Ms.	PROPN	_
Kaum	kaum	NOUN	Number=Sing
konservatif	konservatif	ADJ	_
AKP	AKP	PROPN	Abbr=Yes
penolakan	tolak	NOUN	Number=Sing
pembenaran	benar	NOUN	Number=Sing
Mayoritas	mayoritas	NOUN	Number=Sing
367	367	NUM	NumType=Card
MP	MP	NOUN	Abbr=Yes
550	550	NUM	NumType=Card
walau	walau	SCONJ	_
memicu	picu	VERB	Mood=Ind|Voice=Act
Saint-Gaudens	Saint-Gaudens	PROPN	_
Haute-Garonne	Haute-Garonne	PROPN	_
dibentuk	bentuk	VERB	Mood=Ind|Voice=Pass
pendahuluan	dahulu	NOUN	Number=Sing
Rachida	Rachida	PROPN	_
Dati	Dati	PROPN	_
Nicolas	Nicolas	PROPN	_
Sarkozy	Sarkozy	PROPN	_
Hukum	hukum	NOUN	Number=Sing
Brice	Brice	PROPN	_
Hortefeux	Hortefeux	PROPN	_
fascist	fascist	NOUN	Number=Sing
Negeri	negeri	NOUN	Number=Sing
penjahat	jahat	NOUN	Number=Sing
menghambat	hambat	VERB	Mood=Ind|Voice=Act
ungkapan	ungkap	NOUN	Number=Sing
diatasi	atas	VERB	Mood=Ind|Voice=Pass
diperbolehkan	boleh	VERB	Mood=Ind|Voice=Pass
keagamaan	agama	NOUN	Number=Sing
meja	meja	NOUN	Number=Sing
Force	Force	PROPN	_
Ouvrière	Ouvrière	PROPN	_
ucapan	ucap	NOUN	Number=Sing
isi	isi	NOUN	Number=Sing
panduan	pandu	NOUN	Number=Sing
disertakan	serta	VERB	Mood=Ind|Voice=Pass
Sebenarnya	benar	ADV	_
konsultasi	konsultasi	NOUN	Number=Sing
Gillard	Gillard	PROPN	_
Panduan	pandu	NOUN	Number=Sing
bermasalah	masalah	VERB	Mood=Ind|Voice=Act
dikembangkan	kembang	VERB	Mood=Ind|Voice=Pass
darurat	darurat	NOUN	Number=Sing
Klausul	klausul	NOUN	Number=Sing
klien	klien	NOUN	Number=Sing
banding	banding	VERB	Mood=Ind|Voice=Act
ditolak	tolak	VERB	Mood=Ind|Voice=Pass
Kasasi	kasasi	NOUN	Number=Sing
12	12	NUM	NumType=Card
pertimbangan	timbang	NOUN	Number=Sing
aktual	aktual	ADJ	_
Waktu	waktu	NOUN	Number=Sing
45	45	NUM	NumType=Card
ETA	ETA	PROPN	_
kontingen	kontingen	NOUN	Number=Sing
dokumen	dokumen	NOUN	Number=Sing
Digital	Digital	PROPN	_
nasihat	nasihat	NOUN	Number=Sing
sehubungan	hubung	VERB	Mood=Ind|Voice=Act
memeriksa	periksa	VERB	Mood=Ind|Voice=Act
teliti	teliti	ADV	_
Le	Le	PROPN	_
Figaro	Figaro	PROPN	_
42	42	NUM	NumType=Card
15,5	15,5	NUM	NumType=Card
dialokasikan	alokasi	VERB	Mood=Ind|Voice=Pass
Tina	Tina	PROPN	_
Anselmi	Anselmi	PROPN	_
25	25	NUM	NumType=Card
1927	1927	NUM	NumType=Card
Castelfranco	Castelfranco	PROPN	_
Veneto	Veneto	PROPN	_
anti-fascist	anti	ADJ	_
penganiayaan	aniaya	NOUN	Number=Sing
sosialis	sosialis	NOUN	Number=Sing
militan	militan	ADJ	_
tekstil	tekstil	NOUN	Number=Sing
guru	guru	NOUN	Number=Sing
Sulit	sulit	ADJ	_
dipikirkan	pikir	VERB	Mood=Ind|Voice=Pass
km	km	NOUN	Number=Sing
Madrid	Madrid	PROPN	_
ditekankan	tekan	VERB	Mood=Ind|Voice=Pass
mengevaluasi	evaluasi	VERB	Mood=Ind|Voice=Act
Lagu	lagu	NOUN	Number=Sing
Geronimo	Geronimo	PROPN	_
Sheppard	Sheppard	PROPN	_
dihabiskan	habis	VERB	Mood=Ind|Voice=Pass
Voucher	voucher	NOUN	Number=Sing
dihasilkan	hasil	VERB	Mood=Ind|Voice=Pass
kasir	kasir	NOUN	Number=Sing
kenaikan	naik	NOUN	Number=Sing
bensin	bensin	NOUN	Number=Sing
solar	solar	NOUN	Number=Sing
CGI	CGI	PROPN	_
Mestre	Mestre	PROPN	_
VAT	VAT	NOUN	Abbr=Yes
Suatu	suatu	DET	Number=Sing|PronType=Ind
UE	UE	PROPN	Abbr=Yes
Angka	angka	NOUN	Number=Sing
24	24	NUM	NumType=Card
1.335	1.335	NUM	NumType=Card
liter	liter	NOUN	Number=Sing
1.165	1.165	NUM	NumType=Card
melebihi	lebih	VERB	Mood=Ind|Voice=Act
mengadopsi	adopsi	VERB	Mood=Ind|Voice=Act
tunggal	tunggal	ADJ	_
setara	tara	NOUN	Number=Sing
1.365	1.365	NUM	NumType=Card
Corrado	Corrado	PROPN	_
Passera	Passera	PROPN	_
tawaran	tawar	NOUN	Number=Sing
Mps	Mps	PROPN	_
sikap	sikap	NOUN	Number=Sing
penutupan	tutup	NOUN	Number=Sing
disebutkan	sebut	VERB	Mood=Ind|Voice=Pass
prerogatif	prerogatif	NOUN	Number=Sing
ECB	ECB	PROPN	Abbr=Yes
mengecualikan	kecuali	VERB	Mood=Ind|Voice=Act
alternatif	alternatif	NOUN	Number=Sing
menteri	menteri	NOUN	Number=Sing
penilaian	nilai	NOUN	Number=Sing
Mahasiswa	mahasiswa	NOUN	Number=Sing
LUISS	LUISS	PROPN	Abbr=Yes
bertempat	tempat	VERB	Mood=Ind|Voice=Act
Pagi	pagi	NOUN	Number=Sing
Paus	Paus	PROPN	_
Fransiskus	Fransiskus	PROPN	_
Zuckerberg	Zuckerberg	PROPN	_
Casa	Casa	PROPN	_
Santa	Santa	PROPN	_
Marta	Marta	PROPN	_
mahasiswa	mahasiswa	NOUN	Number=Sing
Tre	Tre	PROPN	_
helm	helm	NOUN	Number=Sing
sepeda	sepeda	NOUN	Number=Sing
mengantisipasi	antisipasi	VERB	Mood=Ind|Voice=Act
pengemudi	kemudi	NOUN	Number=Sing
contoh	contoh	NOUN	Number=Sing
upaya-upaya	upaya	NOUN	Number=Plur
keselamatan	selamat	NOUN	Number=Sing
robot	robot	NOUN	Number=Sing
humanoid	humanoid	NOUN	Number=Sing
berkompetisi	kompetisi	VERB	Mood=Ind|Voice=Act
Rossi	Rossi	PROPN	_
Imbalan	imbal	NOUN	Number=Sing
dolar	dolar	NOUN	Number=Sing
direksi	direksi	NOUN	Number=Sing
China	China	PROPN	_
Wall	Wall	PROPN	_
Silicon	Silicon	PROPN	_
Valley	Valley	PROPN	_
Amazon	Amazon	PROPN	_
keempat	empat	ADJ	NumType=Ord
kapitalisasi	kapitalisasi	NOUN	Number=Sing
ExxonMobil	ExxonMobil	PROPN	_
pemimpin	pimpin	NOUN	Number=Sing
Tesla	Tesla	PROPN	_
Snapchat	Snapchat	PROPN	_
selain	selain	ADP	_
Mountain	Mountain	PROPN	_
View	View	PROPN	_
Summit	Summit	PROPN	_
Community	Community	PROPN	_
Cristina	Cristina	PROPN	_
Cifuentes	Cifuentes	PROPN	_
Sectorial	Sectorial	PROPN	_
Under-Secretary	Under-Secretary	PROPN	_
Javier	Javier	PROPN	_
Maroto	Maroto	PROPN	_
progresif	progresif	ADJ	_
Durán	durán	PROPN	_
Ángel	Ángel	PROPN	_
Pintado	Pintado	PROPN	_
bendahara	bendahara	NOUN	Number=Sing
tingkat	tingkat	NOUN	Number=Sing
pengangguran	anggur	NOUN	Number=Sing
600.000	600.000	NUM	NumType=Card
pencabutan	cabut	NOUN	Number=Sing
dibanggakan	bangga	VERB	Mood=Ind|Voice=Pass
Fátima	Fátima	PROPN	_
Báñez	Báñez	PROPN	_
isu	isu	NOUN	Number=Sing
kontroversial	kontroversial	ADJ	_
Sekretaris	sekretaris	NOUN	Number=Sing
Sumber	sumber	NOUN	Number=Sing
dihubungi	hubung	VERB	Mood=Ind|Voice=Pass
Cospedal	Cospedal	PROPN	_
memahami	paham	VERB	Mood=Ind|Voice=Act
coba	coba	VERB	Mood=Ind|Voice=Act
disampaikan	sampai	VERB	Mood=Ind|Voice=Pass
kemarin	kemarin	ADV	_
Barón	barón	PROPN	_
Claret	Claret	PROPN	_
Pedro	Pedro	PROPN	_
Sánchez	Sánchez	PROPN	_
Évole	Évole	PROPN	_
Federico	Federico	PROPN	_
Fellini	Fellini	PROPN	_
badut	badut	NOUN	Number=Sing
bayangan	bayang	NOUN	Number=Sing
koboi	koboi	NOUN	Number=Sing
pemukulan	pukul	NOUN	Number=Sing
Tekanan	tekan	NOUN	Number=Sing
ironi	ironi	NOUN	Number=Sing
sindiran	sindir	NOUN	Number=Sing
kasar	kasar	ADJ	_
verbal	verbal	ADJ	_
pas	pas	ADJ	_
orasi	orasi	NOUN	Number=Sing
parlementer	parlementer	ADJ	_
dagelan	dagelan	NOUN	Number=Sing
membasahi	basah	VERB	Mood=Ind|Voice=Act
menggali	gali	VERB	Mood=Ind|Voice=Act
misteri	misteri	NOUN	Number=Sing
semangat	semangat	NOUN	Number=Sing
jernih	jernih	ADJ	_
generasi	generasi	NOUN	Number=Sing
khawatir	khawatir	ADJ	_
Latin	Latin	PROPN	_
Pemberian	beri	NOUN	Number=Sing
berdampak	dampak	VERB	Mood=Ind|Voice=Act
hal-hal	hal	NOUN	Number=Plur
direncanakan	rencana	VERB	Mood=Ind|Voice=Pass
oposisi	oposisi	NOUN	Number=Sing
Mundo	Mundo	PROPN	_
Puluhan	puluh	NUM	NumType=Card
FSLN	FSLN	PROPN	Abbr=Yes
merayakan	raya	VERB	Mood=Ind|Voice=Act
Plaza	Plaza	PROPN	_
las	las	PROPN	_
Victorias	Victorias	PROPN	_
May	May	PROPN	_
merespons	respons	VERB	Mood=Ind|Voice=Act
Didirikan	diri	VERB	Mood=Ind|Voice=Pass
1925	1925	NUM	NumType=Card
indah	indah	ADJ	_
beragam	ragam	ADJ	_
Dedikasi	dedikasi	NOUN	Number=Sing
telegraf	telegraf	NOUN	Number=Sing
sinyal	sinyal	NOUN	Number=Sing
kebakaran	bakar	NOUN	Number=Sing
boneka	boneka	NOUN	Number=Sing
diambil	ambil	VERB	Mood=Ind|Voice=Pass
biara	biara	NOUN	Number=Sing
pengusaha	usaha	NOUN	Number=Sing
Georg	Georg	PROPN	_
Reichenbach	Reichenbach	PROPN	_
Württemberg	Württemberg	PROPN	_
ketetapan	tetap	NOUN	Number=Sing
kapas	kapas	NOUN	Number=Sing
Warga	warga	NOUN	Number=Sing
berdiam	diam	VERB	Mood=Ind|Voice=Act
bermigrasi	migrasi	VERB	Mood=Ind|Voice=Act
Biara	Biara	PROPN	_
Peter	Peter	PROPN	_
Paul	Paul	PROPN	_
Balai	balai	NOUN	Number=Sing
Obermarsberg	Obermarsberg	PROPN	_
ke-13	13	ADJ	NumType=Ord
direnovasi	renovasi	VERB	Mood=Ind|Voice=Pass
Puluh	puluh	NUM	NumType=Card
Golden	Golden	PROPN	_
Gate	Gate	PROPN	_
kilometer	kilometer	NOUN	Number=Sing
botani	botani	NOUN	Number=Sing
planetarium	planetarium	NOUN	Number=Sing
akuarium	akuarium	NOUN	Number=Sing
Taman	taman	NOUN	Number=Sing
Taman	Taman	PROPN	_
istirahat	istirahat	VERB	Mood=Ind|Voice=Act
relaksasi	relaksasi	NOUN	Number=Sing
biarawan	biara	NOUN	Number=Sing
San	San	PROPN	_
Francisco	Francisco	PROPN	_
Yerba	Yerba	PROPN	_
Buena	Buena	PROPN	_
Garden	Garden	PROPN	_
atap	atap	NOUN	Number=Sing
Moscone	Moscone	PROPN	_
Convention	Convention	PROPN	_
Center	Center	PROPN	_
terdapat	dapat	VERB	Mood=Ind|Voice=Pass
monumen	monumen	NOUN	Number=Sing
Luther	Luther	PROPN	_
King	King	PROPN	_
Jr.	Jr.	PROPN	_
Buruh	Buruh	PROPN	_
ketujuh	tujuh	NUM	NumType=Card
Baik	baik	CCONJ	_
Baik	baik	ADJ	_
urutan	urut	NOUN	Number=Sing
dibahas	bahas	VERB	Mood=Ind|Voice=Pass
mendalam	dalam	ADV	_
Perdana	perdana	NOUN	Number=Sing
Bosphorus	Bosphorus	PROPN	_
Istanbul	Istanbul	PROPN	_
paralel	paralel	ADJ	_
membutuhkan	butuh	VERB	Mood=Ind|Voice=Act
izin	izin	NOUN	Number=Sing
mempertahankan	tahan	VERB	Mood=Ind|Voice=Act
armada	armada	NOUN	Number=Sing
temuan	temu	NOUN	Number=Sing
Kemungkinan	mungkin	ADV	_
terkenal	kenal	VERB	Mood=Ind|Voice=Pass
Tembaga	Tembaga	PROPN	_
Ötzi	Ötzi	PROPN	_
mummy	mummy	NOUN	Number=Sing
3300	3300	NUM	NumType=Card
BC	BC	NOUN	Abbr=Yes
bukit	bukit	NOUN	Number=Sing
penggilingan	giling	NOUN	Number=Sing
tembaga	tembaga	NOUN	Number=Sing
Keparahan	parah	NOUN	Number=Sing
kehadiran	hadir	NOUN	Number=Sing
revolusi	revolusi	NOUN	Number=Sing
Istana	istana	NOUN	Number=Sing
Majelis	Majelis	PROPN	_
Versailles	Versailles	PROPN	_
kekesalan	kesal	NOUN	Number=Sing
roti	roti	NOUN	Number=Sing
terus-menerus	terus	ADV	_
pelarian	lari	NOUN	Number=Sing
dikenali	kenal	VERB	Mood=Ind|Voice=Pass
Himne	himne	NOUN	Number=Sing
dinyanyikan	nyanyi	VERB	Mood=Ind|Voice=Pass
ulang	ulang	VERB	Mood=Ind|Voice=Act
pergeseran	geser	NOUN	Number=Sing
Krisis	Krisis	PROPN	_
Suez	Suez	PROPN	_
pengambilalihan	ambil-alih	NOUN	Number=Sing
Sosialis	Sosialis	PROPN	_
1933	1933	NUM	NumType=Card
terpencar-pencar	pencar	VERB	Mood=Ind|Voice=Pass
koloni-koloni	koloni	NOUN	Number=Plur
1917	1917	NUM	NumType=Card
Baltik	Baltik	PROPN	_
Hongaria	Hongaria	PROPN	_
kompromi	kompromi	NOUN	Number=Sing
Franz	Franz	PROPN	_
I.	I.	PROPN	Abbr=Yes
mengurusi	urus	VERB	Mood=Ind|Voice=Act
Disibodenberg	Disibodenberg	PROPN	_
dibubarkan	bubar	VERB	Mood=Ind|Voice=Pass
puing-puing	puing	NOUN	Number=Plur
reformasi	reformasi	NOUN	Number=Sing
Rupertsberg	Rupertsberg	PROPN	_
1632	1632	NUM	NumType=Card
biarawati	biara	NOUN	Number=Sing
terlantar	telantar	VERB	Mood=Ind|Voice=Pass
dipindahkan	pindah	VERB	Mood=Ind|Voice=Pass
Eibingen	Eibingen	PROPN	_
Puing-puing	puing	NOUN	Number=Plur
Tim	Tim	PROPN	_
Telekom	Telekom	PROPN	_
pacar	pacar	NOUN	Number=Sing
Merdingen	Merdingen	PROPN	_
Südbaden	Südbaden	PROPN	_
Ulrich	Ulrich	PROPN	_
balap	balap	NOUN	Number=Sing
medali	medali	NOUN	Number=Sing
Sensor	sensor	NOUN	Number=Sing
membuang	buang	VERB	Mood=Ind|Voice=Act
partisipasi	partisipasi	NOUN	Number=Sing
Jejak-jejak	jejak	NOUN	Number=Plur
Weiss	Weiss	PROPN	_
hadiah	hadiah	NOUN	Number=Sing
Cologne	Cologne	PROPN	_
Bremen	Bremen	PROPN	_
privat	privat	ADJ	_
Springer	Springer	PROPN	_
bersemangat	semangat	ADV	_
rekonsiliasi	rekonsiliasi	NOUN	Number=Sing
Israel	Israel	PROPN	_
Pondok	pondok	NOUN	Number=Sing
habis	habis	ADV	_
1977	1977	NUM	NumType=Card
tanda	tanda	NOUN	Number=Sing
kehormatan	hormat	NOUN	Number=Sing
Medali	Medali	PROPN	_
Persahabatan	Persahabatan	PROPN	_
ramah	ramah	ADJ	_
pers	pers	NOUN	Number=Sing
Distrik	distrik	NOUN	Number=Sing
Viguier	Viguier	PROPN	_
La	La	PROPN	_
Conte	Conte	PROPN	_
Sejarah	sejarah	NOUN	Number=Sing
Carcassonne	Carcassonne	PROPN	_
dibentengi	benteng	VERB	Mood=Ind|Voice=Pass
2000-an	2000	NUM	NumType=Card
dokter	dokter	NOUN	Number=Sing
100.000	100.000	NUM	NumType=Card
Amnesty	Amnesty	PROPN	_
artikel	artikel	NOUN	Number=Sing
koran	koran	NOUN	Number=Sing
dituduh	tuduh	VERB	Mood=Ind|Voice=Pass
sihir	sihir	NOUN	Number=Sing
Bellingshausen	Bellingshausen	PROPN	_
Antartika	Antartika	PROPN	_
27	27	NUM	NumType=Card
1820	1820	NUM	NumType=Card
Bransfield	Bransfield	PROPN	_
Palmer	Palmer	PROPN	_
Endurance	Endurance	PROPN	_
1914	1914	NUM	NumType=Card
kapten	kapten	NOUN	Number=Sing
Sir	Sir	PROPN	_
Ernest	Ernest	PROPN	_
Shackleton	Shackleton	PROPN	_
awak	awak	NOUN	Number=Sing
Antarktika	Antarktika	PROPN	_
Susunan	susun	NOUN	Number=Sing
lembaga	lembaga	NOUN	Number=Sing
mos	mos	X	_
maiorum	maiorum	X	_
Pyrrhus	Pyrrhus	PROPN	_
dipaksa	paksa	VERB	Mood=Ind|Voice=Pass
mengurus	urus	VERB	Mood=Ind|Voice=Act
Kegelapan	Kegelapan	PROPN	_
Mycenaean	Mycenaean	PROPN	_
Kecakapan	cakap	NOUN	Number=Sing
terbagi	bagi	VERB	Mood=Ind|Voice=Pass
komunitas	komunitas	NOUN	Number=Sing
ditentukan	tentu	VERB	Mood=Ind|Voice=Pass
geografi	geografi	NOUN	Number=Sing
lembah	lembah	NOUN	Number=Sing
terisolasi	isolasi	ADJ	_
pegunungan	gunung	NOUN	Number=Sing
Alkitab	Alkitab	PROPN	_
Perdagangan	dagang	NOUN	Number=Sing
terdepan	depan	ADJ	Degree=Sup
Hubungan	hubung	NOUN	Number=Sing
asmara	asmara	NOUN	Number=Sing
revolusioner	revolusioner	NOUN	Number=Sing
Pluviose	Pluviose	PROPN	_
Februari	Februari	PROPN	_
1794	1794	NUM	NumType=Card
meringankan	ringan	VERB	Mood=Ind|Voice=Act
Reign	Reign	PROPN	_
Terror	Terror	PROPN	_
Dibiayai	biaya	VERB	Mood=Ind|Voice=Pass
Bernard	Bernard	PROPN	_
Tapie	Tapie	PROPN	_
sekolah-sekolah	sekolah	NOUN	Number=Plur
distributor	distributor	NOUN	Number=Sing
nomor	nomor	NOUN	Number=Sing
melarikan	lari	VERB	Mood=Ind|Voice=Act
Remis	Remis	PROPN	_
1947	1947	NUM	NumType=Card
Sekembalinya	kembali	NOUN	Number=Sing
menyimpan	simpan	VERB	Mood=Ind|Voice=Act
Belgia	Belgia	PROPN	_
semi	semi	NOUN	Number=Sing
1948	1948	NUM	NumType=Card
mengadaptasi	adaptasi	VERB	Mood=Ind|Voice=Act
Tintin	Tintin	PROPN	_
tayangan	tayang	NOUN	Number=Sing
Walt	Walt	PROPN	_
sia-sia	sia	ADV	_
Georges	Georges	PROPN	_
ditemani	teman	VERB	Mood=Ind|Voice=Pass
Rosane	Rosane	PROPN	_
18	18	NUM	NumType=Card
Gerrmaine	Gerrmaine	PROPN	_
nikah	nikah	NOUN	Number=Sing
akui	aku	VERB	Mood=Ind|Voice=Act
pohon-pohon	pohon	NOUN	Number=Plur
menghadap	hadap	VERB	Mood=Ind|Voice=Act
kecintaan	cinta	NOUN	Number=Sing
Pulau-pulau	pulau	NOUN	Number=Plur
Patahan	Patahan	PROPN	_
Indo-Australia	Indo-Australia	PROPN	_
patahan	patah	NOUN	Number=Sing
tabrakan	tabrak	NOUN	Number=Sing
pelat	pelat	NOUN	Number=Sing
hipotesis	hipotesis	NOUN	Number=Sing
peternakan	ternak	NOUN	Number=Sing
kerajaan	raja	NOUN	Number=Sing
hebat	hebat	ADJ	_
Villa	Villa	PROPN	_
Pelucca	Pelucca	PROPN	_
Sesto	Sesto	PROPN	_
Giovanni	Giovanni	PROPN	_
1928	1928	NUM	NumType=Card
hektar	hektar	NOUN	Number=Sing
samping	samping	NOUN	Number=Sing
gelanggang	gelanggang	NOUN	Number=Sing
pacuan	pacu	NOUN	Number=Sing
1976	1976	NUM	NumType=Card
1990	1990	NUM	NumType=Card
menghancurkan	hancur	VERB	Mood=Ind|Voice=Act
sisa-sisa	sisa	NOUN	Number=Plur
tribun	tribun	NOUN	Number=Sing
terbuat	buat	VERB	Mood=Ind|Voice=Pass
kandang-kandang	kandang	NOUN	Number=Plur
1969	1969	NUM	NumType=Card
VI	vi	ADJ	NumType=Ord
Vatikan	Vatikan	PROPN	_
mencabut	cabut	VERB	Mood=Ind|Voice=Act
Diterbitkan	terbit	NOUN	Number=Sing
bersifat	sifat	VERB	Mood=Ind|Voice=Act
numismatik	numismatik	ADJ	_
kolektor	kolektor	NOUN	Number=Sing
datar	datar	ADJ	_
berbukit	bukit	VERB	Mood=Ind|Voice=Act
Terdapat	dapat	VERB	Mood=Ind|Voice=Pass
artefak	artefak	NOUN	Number=Sing
menhir	menhir	NOUN	Number=Sing
dolmen	dolmen	NOUN	Number=Sing
Wilayah	wilayah	NOUN	Number=Sing
Apulia	Apulia	PROPN	_
Calabria	Calabria	PROPN	_
Samnium	Samnium	PROPN	_
Molise	Molise	PROPN	_
Basilicata	Basilicata	PROPN	_
oriental	oriental	ADJ	_
menandakan	tanda	VERB	Mood=Ind|Voice=Act
Sejarawan	sejarawan	NOUN	Number=Sing
Crouch	Crouch	PROPN	_
kesan	kesan	NOUN	Number=Sing
earl	earl	X	_
simbolik	simbolik	ADJ	_
Koalisi	koalisi	NOUN	Number=Sing
Korsika	Korsika	PROPN	_
mendapat	dapat	VERB	Mood=Ind|Voice=Act
pencerahan	cerah	NOUN	Number=Sing
Napoleon	Napoleon	PROPN	_
Bonaparte	Bonaparte	PROPN	_
pemecah	pecah	NOUN	Number=Sing
Pertempuran	tempur	NOUN	Number=Sing
Marengo	Marengo	PROPN	_
Penghadangan	hadang	NOUN	Number=Sing
Villeneuve	Villeneuve	PROPN	_
penghentian	henti	NOUN	Number=Sing
invasi	invasi	NOUN	Number=Sing
British	British	PROPN	_
Isles	Isles	PROPN	_
Austerlitz	Austerlitz	PROPN	_
Grenville	Grenville	PROPN	_
Tsar	Tsar	PROPN	_
Sehubungan	hubung	VERB	Mood=Ind|Voice=Act
Fiorello	Fiorello	PROPN	_
dididik	didik	VERB	Mood=Ind|Voice=Pass
Episkopal	Episkopal	PROPN	_
Protestan	Protestan	PROPN	_
Pria	pria	NOUN	Number=Sing
semesta	semesta	NOUN	Number=Sing
Walter	Walter	PROPN	_
Olivia	Olivia	PROPN	_
dilatih	latih	VERB	Mood=Ind|Voice=Pass
Goffredo	Goffredo	PROPN	_
Petrassi	Petrassi	PROPN	_
Ennio	Ennio	PROPN	_
Morricone	Morricone	PROPN	_
Bruno	Bruno	PROPN	_
Nicolai	Nicolai	PROPN	_
konservatorium	konservatorium	NOUN	Number=Sing
Cecelia	Cecelia	PROPN	_
berkolaborasi	kolaborasi	VERB	Mood=Ind|Voice=Act
susunan	susun	NOUN	Number=Sing
sinematik	sinematik	ADJ	_
Metti	Metti	PROPN	_
makan	makan	NOUN	Number=Sing
persahabatan	sahabat	NOUN	Number=Sing
kolaborasi	kolaborasi	NOUN	Number=Sing
sengketa	sengketa	NOUN	Number=Sing
solusi	solusi	NOUN	Number=Sing
bergaya	gaya	VERB	Mood=Ind|Voice=Act
aransemen	aransemen	NOUN	Number=Sing
mencirikan	ciri	VERB	Mood=Ind|Voice=Act
gaya	gaya	NOUN	Number=Sing
1904	1904	NUM	NumType=Card
Antonio	Antonio	PROPN	_
Gaudí	Gaudí	PROPN	_
menghadirkan	hadir	VERB	Mood=Ind|Voice=Act
Memiliki	milik	VERB	Mood=Ind|Voice=Act
kapel	kapel	NOUN	Number=Sing
sejajar	jajar	ADJ	_
menyamping	samping	VERB	Mood=Ind|Voice=Act
dinding-dinding	dinding	NOUN	Number=Plur
penopang	topang	NOUN	Number=Sing
Tradisi	tradisi	NOUN	Number=Sing
tema	tema	NOUN	Number=Sing
sengaja	sengaja	ADV	_
Palma	Palma	PROPN	_
Andes	Andes	PROPN	_
rangkaian	rangkai	NOUN	Number=Sing
tipo	tipo	PROPN	_
andino	andino	PROPN	_
subduksi	subduksi	NOUN	Number=Sing
kerak	kerak	NOUN	Number=Sing
Linares	Linares	PROPN	_
Pemulihan	pulih	NOUN	Number=Sing
menggulingkan	guling	VERB	Mood=Ind|Voice=Act
disetujui	tuju	VERB	Mood=Ind|Voice=Pass
partai-partai	partai	NOUN	Number=Plur
dilegalisasi	legalisasi	VERB	Mood=Ind|Voice=Pass
buangan	buang	NOUN	Number=Sing
diizinkan	izin	VERB	Mood=Ind|Voice=Pass
dibebaskan	bebas	VERB	Mood=Ind|Voice=Pass
Ambruk	ambruk	VERB	Mood=Ind|Voice=Act
puluhan	puluh	NUM	NumType=Card
imajiner	imajiner	NOUN	Number=Sing
landmark	landmark	X	Foreign=Yes
mercu	mercu	NOUN	Typo=Yes
suar	suar	NOUN	Typo=Yes
Punta	Punta	PROPN	_
del	del	PROPN	_
Este	Este	PROPN	_
Rasa	Rasa	PROPN	_
Hal-hal	hal	NOUN	Number=Plur
1777	1777	NUM	NumType=Card
Burgoyne	Burgoyne	PROPN	_
Saratoga	Saratoga	PROPN	_
coup	coup	X	Foreign=Yes
grâce	grâce	X	Foreign=Yes
Indian	Indian	PROPN	_
Brant	Brant	PROPN	_
kolonis	kolonis	NOUN	Number=Sing
Ekspedisi	ekspedisi	NOUN	Number=Sing
Albany	Albany	PROPN	_
dihadang	hadang	VERB	Mood=Ind|Voice=Pass
Freeman	Freeman	PROPN	_
Hudson	Hudson	PROPN	_
Era	era	NOUN	Number=Sing
Keemasan	emas	NOUN	Number=Sing
Modern	modern	ADJ	_
Awal	awal	NOUN	Number=Sing
varian	varian	NOUN	Number=Sing
eksternal	eksternal	ADJ	_
referensi	referensi	NOUN	Number=Sing
penutur	tutur	NOUN	Number=Sing
perubahan-perubahan	ubah	NOUN	Number=Plur
putri-putri	putri	NOUN	Number=Plur
Luis	Luis	PROPN	_
X	x	ADJ	NumType=Ord
Felipe	Felipe	PROPN	_
V	v	ADJ	NumType=Ord
klaim	klaim	NOUN	Number=Sing
tahta	tahta	NOUN	Number=Sing
tante	tante	NOUN	Number=Sing
Isabella	Isabella	PROPN	_
berdamai	damai	VERB	Mood=Ind|Voice=Act
1415	1415	NUM	NumType=Card
Enrique	Enrique	PROPN	_
federalisasi	federalisasi	NOUN	Number=Sing
Buenos	Buenos	PROPN	_
Aires	Aires	PROPN	_
perluasan	luas	NOUN	Number=Sing
komersial	komersial	ADJ	_
jenderal	jenderal	NOUN	Number=Sing
angkatan	angkat	NOUN	Number=Sing
darat	darat	NOUN	Number=Sing
Rocket	Rocket	PROPN	_
Record	Record	PROPN	_
Company	Company	PROPN	_
Kiki	Kiki	PROPN	_
Dee	Dee	PROPN	_
Do	Do	PROPN	_
Go	Go	PROPN	_
Breaking	Breaking	PROPN	_
Heart	Heart	PROPN	_
Pompey	Pompey	PROPN	_
legiun	legiun	NOUN	Number=Sing
Capua	Capua	PROPN	_
retribusi	retribusi	NOUN	Number=Sing
ilegal	ilegal	ADJ	_
pendukung	dukung	NOUN	Number=Sing
Caesar	Caesar	PROPN	_
César	césar	PROPN	_
Curio	Curio	PROPN	_
ditempati	tempat	VERB	Mood=Ind|Voice=Pass
Marco	Marco	PROPN	_
menjawab	jawab	VERB	Mood=Ind|Voice=Act
definitif	definitif	ADJ	_
bersaing	saing	VERB	Mood=Ind|Voice=Act
konsulate	konsulate	NOUN	Typo=Yes
pilih	pilih	VERB	Mood=Ind|Voice=Act
senjata	senjata	NOUN	Number=Sing
lawan-lawan	lawan	NOUN	Number=Plur
49	49	NUM	NumType=Card
deklarasi	deklarasi	NOUN	Number=Sing
prokonsul	prokonsul	NOUN	Number=Sing
